一切	HVX OMS
一般	HVX ADA
下載	JNR PTS
不禁	AXP D1Y
不要	AXP HIW
不錯	AXP OQT
丞相	ZWQ QPS
並行	CVB JRQ
中肯	JBC EXR
主要	XKH HIW
乾坤	FGY EAG
乾媽	DCQ DNA
乾旱	DCQ JCR
乾涸	DCQ JQT
乾淨	DCQ PUR
乾燥	DCQ QKR
乾爹	DCQ EOQ
乾爽	DCQ VPR
乾脆	DCQ ONI
乾貨	DCQ ILI
交易	DJQ LUT
人種	CVQ XDB
以爲	LHR KFO
休假	IYM DNS
住宿	LKI QBD
佛教	CXP DJS
作爲	NQT KFO
使用	VHR LDC
使館	VHS DCI
供奉	DDM CDN
促使	ODD VHR
信函	QVS J6Q
倒數	EKS VKH
倒數	EKS VKI
值得	LWT EXT
值錢	LWT PGQ
假使	DNR VHR
假日	DNS CVT
停車	GVQ YOQ
傍晚	CQC DZN
傳承	LGG ZWQ
傳統	LGG FCC
傳說	LGG AGJ
儲藏	LJQ PQQ
充分	YBA CXO
典當	EFR EQS
再見	NTS DFS
冠軍	DCI DXS
出使	YVJ VHS
出發	YVJ AZP
分子	CXO NHR
分子	AXM NHR
分行	AXM JQQ
切割	OFT DCT
切實	OMS BVT
判斷	BCC ECI
刺殺	OFS VET
勝任	AWQ C1S
勝利	AWS IGS
勝地	AWS GGS
區別	EKS AGL
占卜	X4Q AAD
即使	NWT VHR
厭惡	H4W HLC
參差	T1Q TFQ
參與	O2Q LJS
參觀	O2Q DCG
反應	AZN HWE
反覆	AZN BBP
召喚	LIS ICI
名勝	DUE AWS
命令	DSK IUS
咽喉	HFQ JZA
哽咽	DRR HFT
喜好	IHD IKS
單調	ECQ GHS
因爲	HVU KFQ
土著	FLB LPT
壟斷	IDB GCH
夏天	JNS FFQ
夏季	JNS DGM
多少	ELQ AIR
多數	ELQ VKI
大使	GOS VHS
契約	EMS HPF
好處	IKR YJS
姥姥	IKR IKR
姥爺	IKR LOQ
子女	NHR MJR
學校	JED JJS
宗教	NCA DJS
容易	LDA LFS
宿舍	QBD AOS
寶藏	AKB PQS
將領	NPS IUR
尊重	NAG LDB
對應	ESI HWE
少年	AIS HFQ
少數	AIR VKI
少量	AIR IPS
尺度	YUT GLC
居住	DJC LKI
差別	TNQ AGL
差池	TFQ LFQ
差異	TPQ LHS
差異	TNQ LHS
平反	CSI BZM
幾乎	DIC JLA
彈劾	GCQ JXT
後來	JZB ITQ
後悔	JZB ISH
從容	ODA LDA
復辟	CBP AUH
德行	EXT JRS
快樂	ERI IQT
恐怕	EDO BNC
恐懼	EDN FKU
情調	PUQ GHS
愛好	HTS IKS
慘重	O2R LDB
應對	HWE ESI
應當	HWC EQQ
所在	VJR PTS
投降	GZA JEA
挑戰	GHR XGS
挑選	FHQ QGH
排行	CQA JQS
推廣	FSG DQH
推敲	FSG EJQ
推理	YGG IHR
推薦	YGG NFS
推行	FSG JRQ
援引	KZS LVR
擅長	ZGS LPQ
操作	OKQ NQT
支援	XFQ KGQ
政治	XUS LHS
效率	JJS IVJ
救援	DYO KGQ
教學	DJS JED
教師	DJS VGQ
教徒	DJS GLA
教授	DJS ZYC
教授	DJQ ZYC
教書	DJQ AJQ
教會	DJS JOI
教會	DJQ JOI
教育	DJS LBD
教養	DJS LPR
數字	VKI PHS
數學	VKI JED
數量	VKI IPS
料理	IHQ IHR
旁聽	CQA FVQ
旅舍	IJR AOS
暴雨	CKC KKT
暴露	CAD ILC
曲調	EDP GHS
書畫	AJQ JPI
曾經	PXQ DVQ
會計	DOI DMS
朝廷	LIQ GVQ
朝陽	LIQ LPQ
朝陽	JIQ LPQ
朝霞	JIQ JNQ
枸杞	DZB EHD
校友	JJS KYN
校園	JJS KZS
校對	DJS ESI
校慶	JJS ESA
校服	JJS CBP
校歌	JJS DLQ
校舍	JJS AOS
校規	JJS DFK
校訓	JJS IXU
校長	JJS JPR
概率	DTS IVJ
樂園	IQT KZS
樂意	IQT HHE
樂曲	GED EDP
樂章	GED XPQ
樂觀	IQT DCG
樸素	BED QLC
樹幹	ZKI DCS
樹立/豎立	ZKH I1T
次數	OGS VKI
次要	OGS HIW
歡樂	ICG IQT
正在	XUS PTR
正好	XUS IKR
步行	CLC JRQ
母校	DZB JJS
決斷	DFJ ECI
汽車	EIE YOQ
注重	XKI LDB
測量	TWT IPQ
滑稽	DAJ DMQ
火車	ILH YOQ
照相	XIS QPS
燕子	HFS NHR
爲了	KFQ IHR
爲何	KFQ JLQ
爲難	KFO HCQ
爲首	KFO AYB
物種	DXP XDB
理論	IHR IAI
相互	QPQ JLC
相似	QPQ RHR
相傳	QPQ LGG
相同	QPQ GAA
相應	QPQ HWE
相機	QPS DIC
相比	QPQ AGF
相片	QPS BFC
相符	QPQ CKM
相處	QPQ YJR
相貌	QPS DJC
相通	QPQ FAA
相逢	QPQ CDM
相鄰	QPQ IVQ
相類	QPQ IGI
看守	ECQ AYB
睡覺	ZFI DJS
票價	BIG DNS
種子	XDB NHR
種族	XDB PAD
種植	XDC ZWT
積分	NUT AXM
空缺	EAC EGN
空閒	EAA DEQ
答應	E2T HWE
節省	NFT VSR
簡易	DER LFS
素質	QLC XVT
給予	D1B LJR
經過	DVQ DLG
翹楚	FIU TJR
聲調	AUQ GHS
至少	XGS AIR
芍藥	ZPT LPT
花費	ING BIO
茶几	LNQ DGZ
荷花	JLQ ING
荸薺	CAD PGQ
華僑	JNG FIY
著名	JJS DUE
藏品	PQQ B1J
處方	YJR APM
處於	YJR HJC
處理	YJR IHR
處置	YJR JHS
行事	JRQ UHS
行人	JRQ CVQ
行列	JQQ IGT
行動	JRQ GAB
行情	JQQ PUQ
行政	JRQ XUS
行星	JRQ QVQ
行李	JRQ IHR
行業	JQQ G8F
行爲	JRQ KFO
行走	JRQ NZB
行蹤	JRQ NDA
行車	JRQ YOQ
行銷	JRQ QIQ
複雜	ABP P2T
要求	HIU FYM
覆蓋	BYO DOS
觀光	DCG DQG
觀感	DCG D2R
觀望	DCG DPO
觀看	DCG ECS
觀衆	DCG XBC
計劃	DMS JTJ
評論	CSI IAI
說服	ANI CBP
調整	GHQ XUR
調理	GHQ IHR
調節	GHQ NFT
調解	GHQ DPR
負荷	CYN JLR
貫穿	DCG YGG
貿易	DZC LUT
車票	YOQ BIG
車道	YOQ GKR
車隊	YOQ GSI
輸贏	AKG LUQ
輸送	AKI QAC
轉型	JGH JVQ
轉換	JGH JCI
轉賬	JGH JPS
轉載	JGH PTS
轉運	JGH KXU
這些	XOR QOQ
造訪	OKS BPO
進度	NVS GLC
進行	NVS JRQ
遊說	LYA ANI
運載	KXU PTS
運輸	KXU AKI
過去	DLI EJE
過錯	DLI OQT
道觀	GKR DCI
避難	CFG HCS
邪惡	ROQ HQT
部署	CZB ZJS
部隊	CLB GSI
郵遞	KYM GMS
重新	LDA QVQ
重組	LDA NLB
重複	LDA CYO
重要	LDB HIW
重視	LDB ZGS
重量	LDB IPS
重點	LDB E5R
銀行	GVY JQQ
錯亂	OQT ICI
錯誤	OQT GLC
附着	CKO LPT
附近	CKO FYD
降落	DEC IQT
院校	KGQ JJS
電腦	GFS HKR
面相	DGG QPS
音樂	H1Y GED
頻率	CVE IVJ
馬車	DNB YOQ
高校	DKQ JJS
暴風雨	CKC ABM KKT
自行車	PGS JRQ YOQ
審時度勢	A1R ZHQ GQT ANS
一代	HVX GTS
一共	HVX FDO
一再	HVX NTS
一半	HVX ACC
一同	HVX GAA
一向	HVX IPE
一如	HVX CJQ
一定	HVX GVS
一帶	HVX EOS
一度	HVX GLC
一律	HVX IVJ
一心	HVX Q1Q
一手	HVX AYB
一旁	HVX CQA
一旦	HVX ECS
一早	HVX NKR
一時	HVX ZHQ
一氣	HVX EIE
一流	HVX IYA
一直	HVX LWT
一線	HVX QGS
一致	HVX JGS
一舉	HVX DJD
一起	HVX EHD
一身	HVX AVQ
一連	HVX IGQ
一邊	HVX AFA
一陣	HVX LVS
一面	HVX DGG
一頭	HVX GZA
一體	HVX FMR
一齊	HVX PMQ
丈夫	LPR AKM
三角	Q3Q DED
上來	ZPR ITQ
上去	ZPR EJE
上司	ZPS QHQ
上場	ZPR LPQ
上學	ZPR JED
上層	ZPS PXQ
上山	ZPR VEQ
上岸	ZPR GCS
上市	ZPR ZHR
上流	ZPS IYA
上游	ZPS LYA
上班	ZPR ADA
上空	ZPS EAA
上等	ZPS EXR
上級	ZPS D1B
上衣	ZPS HIC
上課	ZPR ELI
上身	ZPS AVQ
上邊	ZPS AFA
上門	ZPR DAA
上陣	ZPR LVS
上面	ZPS DGG
上馬	ZPR DNB
下層	JNR PXQ
下屬	JNR ZDD
下巴	JNR ANA
下旬	JNR RVG
下身	JNR AVQ
下邊	JNR AFA
下面	JNR DGG
丘陵	EYM IWQ
並排	CVB CQA
並進	CVB NVS
丫頭	HNQ GZA
中堅	JBA DFQ
中場	JBA LPQ
中年	JBA HFQ
中庸	JBA LDA
中心/忠心	JBA Q1Q
中性	JBA QUS
中流	JBA IYA
中程	JBA LUQ
中立	JBA I1T
中等	JBA EXR
中裝	JBA SPQ
中途	JBA GLA
中鋒	JBA BDM
主人	XKH CVQ
主力	XKH IWT
主動	XKH GAB
主場	XKH LPQ
主婦	XKH CYN
主宰	XKH NTR
主導	XKH GKS
主席	XKH RUT
主廚	XKH LKG
主意	XKH HHE
主持	XKH LHQ
主教	XKH DJS
主旨	XKH XGR
主權	XKH FGO
主流	XKH IYA
主演	XKH LGR
主管	XKH DCH
主義	XKH GFA
主講	XKH DEB
主辦	XKH CEC
主體	XKH FMR
乃至	HTR XGS
久違	DYN KIS
之前	XHQ PFQ
乏力	C9P IWT
乏味	C9P DIO
乞丐	EYF DOS
也許	LOR IJD
乳糖	CKH GQQ
乳豬	CKH JJQ
乳酪	CKH IQT
亂倫	ICI IVG
了結	IHR DFT
二手	CGS AYB
二胡	CGS JLA
互利	JLC IGS
互助	JLC UJS
互動	JLC GAB
互惠	JLC JMI
互換	JLC JCI
互補	JLC ALB
互訪	JLC BPO
交付	DJQ AKO
交代	DJQ GTS
交往	DJQ KPT
交待	DJQ GTR
交接	DJQ N4T
交換	DJQ JCI
交替	DJQ FMS
交流	DJQ IYA
交界	DJQ DQS
交融	DJQ LBA
交談	DJQ G3Q
交通	DJQ FAA
交鋒	DJQ BDM
交際	DJQ NNS
京劇	DSY FSB
京城	DSY ZUQ
京師	DSY VGQ
亮相	IPS QPS
人中	CVQ JBA
人力	CVQ IWT
人口	CVQ EZB
人名	CVQ DUE
人員	CVQ KXS
人均	CVQ DVK
人士	CVQ UHR
人家	CVQ DNQ
人工	CVQ DAA
人心	CVQ Q1Q
人性	CVQ QUS
人情	CVQ PUQ
人才	CVQ PTQ
人文	CVQ DXM
人權	CVQ FGO
人次	CVQ OGS
人民	CVQ DVE
人氣	CVQ EIE
人流	CVQ IYA
人潮	CVQ LIQ
人煙	CVQ HFQ
人物	CVQ DXP
人生	CVQ VSQ
人緣	CVQ LGG
人身	CVQ AVQ
人間	CVQ DES
人際	CVQ NNS
人類	CVQ IGI
人體	CVQ FMR
什錦	Z1T D1Z
仁愛	CVQ HTS
仇人	FYM CVQ
仇恨	FYM JBS
今天	D1Y FFQ
今年	D1Y HFQ
今日	D1Y CVT
介入	DQS C1T
介意	DQS HHE
介紹	DQS ZIR
仍然	CWQ CGQ
仍舊	CWQ FYO
他人	FLQ CVQ
付款	AKO ECH
仙丹	QGQ ECQ
仙境	QGQ DSZ
仙子	QGQ NHR
代價	GTS DNS
代替	GTS FMS
代理	GTS IHR
代表	GTS AIJ
代課	GTS ELI
代謝	GTS ROS
以來	LHR ITQ
以免	LHR DGJ
以前	LHR PFQ
以及	LHR F1B
以外	LHR GOI
以往	LHR KPT
以期	LHR FHC
以至	LHR XGS
以致	LHR JGS
仿照	BPN XIS
仿製	BPN XNS
休息	IYM QWT
休憩	IYM ENA
休會	IYM JOI
休閒	IYM DEQ
伯伯	ARD ARD
估價/股價	DLB DNS
估算	DLB QCH
估計	DLB DMS
伶人	IVQ CVQ
伶仃	IVQ EVQ
伸展	AVQ JGR
伸手/身手	AVQ AYB
似乎	RHR JLA
似的	RHR EVT
佇立	LJR I1T
佈局	ALC FDP
佈景	ALC DSZ
佈置	ALC JHS
位置	KGQ JHS
低估	EMQ DLB
低廉	EMQ I4Q
低沉	EMQ L1Q
低溫	EMQ HAG
低潮	EMQ LIQ
低窪	EMQ HNG
低級	EMQ D1B
低落	EMQ IQT
低迷	EMQ DMA
低音	EMQ H1Y
低頭	EMQ GZA
住房	LKI CPM
住所	LKI VJR
佐酒	NLS NYB
佔據	E5Q DJE
佔有	E5Q KYN
佔用	E5Q LDC
佔領	E5Q IUR
佛像	CXP RPR
佛學	CXP JED
佛寺	CXP RHS
佛祖	CXP NLB
佛陀	CXP GLQ
佩戴	CSC ETS
佩服	CSC CBP
佳節	DPQ NFT
來信	ITQ QVS
來勢	ITQ ANS
來回	ITQ JSG
來往	ITQ KPT
來源	ITQ GZS
例外	INS GOI
例子	INS NHR
例證	INS XWS
侍奉	ZHS CDN
侍者	ZHS XOR
依偎	HIC HSG
依存	HIC PAG
依循	HIC RVG
依戀	HIC IGI
依據	HIC DJE
依次	HIC OGS
依法	HIC A9P
依然	HIC CGQ
依照	HIC XIS
依稀	HIC IIC
依舊	HIC FYO
依賴	HIC IOS
依附	HIC CKO
依靠	HIC EKS
侮辱	DKN CDD
侵佔	O1Q E5Q
侵入	O1Q C1T
侵擾	O1Q CIR
侵權	O1Q FGO
侵犯	O1Q C9N
侵略	O1Q IPT
侵蝕	O1Q BWT
促成	ODD ZUQ
促進	ODD NVS
促銷	ODD QIQ
俗名	RDD DUE
俘虜	BKM ILB
保佑	AKB KYO
保存	AKB PAG
保安	AKB HCQ
保密	AKB DVL
保持	AKB LHQ
保暖	AKB HCH
保本	AKB AAB
保稅	AKB ANI
保管	AKB DCH
保育	AKB LBD
保證	AKB XWS
保護	AKB JLC
保釋	AKB AUT
保險	AKB I4Z
俠義/協議	J5T GFA
信奉	QVS CDN
信徒	QVS GLA
信心	QVS Q1Q
信念	QVS H5S
訊息/信息	QVS QWT
信服	QVS CBP
信物	QVS DXP
信用	QVS LDC
信箱	QVS QPQ
信託	QVS FQT
信貸	QVS FTS
修剪	QYA NGR
修士	QYA UHR
修建	QYA DZE
修改	QYA DTR
修業	QYA G8F
修理	QYA IHR
修繕	QYA ZGS
修習	QYA R1T
修補	QYA ALB
修身	QYA AVQ
修辭	QYA RHQ
修飾	QYA AWT
俯瞰	AKN E3S
俯身	AKN AVQ
俱全	DKS PGG
倉庫	OQQ ELC
個人	DLS CVQ
個別	DLS CGL
個性	DLS QUS
個案	DLS HCS
個體	DLS FMR
倔強	FXV FPC
倫理	IVG IHR
值得	LHS EXT
偏偏	BGE BGE
偏向	BGE IPE
偏執	BGE X1T
偏好	BGE IKS
偏愛	BGE HTS
偏激	BGE DVT
停工	GVQ DAA
停機	GVQ DIC
停歇	GVQ IZF
停止	GVQ XHR
停滯	GVQ LNS
停站	GVQ J6S
停職	GVQ XWT
停課	GVQ ELI
停靠	GVQ EKS
停頓	GVQ EAI
健全	FZE PGG
健壯	FZE SPS
健康	FZE EQQ
健碩	FZE ZUT
健身	FZE AVQ
側目	SWT DBP
側面	SWT DGG
偷偷	FZA FZA
偷懶	FZA ICR
偷渡	FZA GLC
偷襲	FZA R1T
偷閒	FZA DEQ
備份	CGK AVI
備戰	CGK XGS
備案	CGK HCS
備用	CGK LDC
催促	OSG ODD
催化	OSG INI
催淚	OSG IGI
催眠	OSG DFA
傲慢	GKS DDC
傳教	LGG DJS
傾向	EUK IPE
傾慕	EUK DLC
傾盆	EUK CAA
傾訴	EUK QLC
傾談	EUK G3Q
傾軋	EUK HET
傾銷	EUK QIQ
僵化	DPC INI
僵持	DPC LHQ
僵硬	DPC GTS
價值	DNS LHS
價目	DNS DBP
價碼	DNS DNB
價錢	DNS PGQ
儀器	GFY EGA
儀容	GFY LDA
儀式	GFY AWT
儀表	GFY AIJ
儒學	CKG JED
儒家	CKG DNQ
儒雅	CKG GNR
優劣	HYM IGJ
優勢	HYM ANS
優化	HYM INI
優惠	HYM JMI
優異	HYM LHS
優秀	HYM QYC
優美	HYM DGJ
優良	HYM IPQ
優雅	HYM GNR
優點	HYM E5R
儲備	LJQ CGK
儲存	LJQ PAG
儲蓄	LJQ KBD
儼然	G8D CGQ
允許	LVH IJD
允諾	LVH HQT
元宵	GZS QIQ
元旦	GZS ECS
元素	GZS QLC
元老	GZS IKR
充公	YBA DAA
充實	YBA BVT
充斥	YBA YUT
充滿	YBA DCB
充裕	YBA LKI
充電	YBA GFS
充飢	YBA DGY
兆頭	LIR GZA
光亮	DQG IPS
光彩	DQG OTR
光影	DQG HSZ
光榮	DQG KSO
光照	DQG XIS
光線	DQG QGS
光纜	DQG I3S
光輝	DQG IIS
光顧	DQG DLC
克制	EXT XNS
克服	EXT CBP
免得	DGJ EXT
免疫	DGJ LUJ
免稅	DGJ ANI
免職	DGJ XWT
兒化	CFQ INI
兒子	CFQ NHR
兒歌	CFQ DLQ
兒科	CFQ ELG
兒童	CFQ GAA
兔子	FLC NHR
兜售	EZA ZYC
入伍	C1T GLB
入侵	C1T O1Q
入口	C1T EZB
入境	C1T DSZ
入夜	C1T LOS
入學	C1T JED
入座	C1T PLI
入手	C1T AYB
入睡	C1T ZFI
入股	C1T DLB
入門	C1T DAA
全力	PGG IWT
全局	PGG FDP
全文	PGG DXM
全新	PGG QVQ
全民	PGG DVE
全然	PGG CGQ
全球	PGG FYM
全盤	PGG CCA
全程	PGG LUQ
全職	PGG XWT
全貌	PGG DJC
全身	PGG AVQ
全都	PGG ELA
全面	PGG DGG
全體	PGG FMR
八卦	AED DPI
八字	AED PHS
八成	AED ZUQ
公主	DAA XKH
公佈	DAA ALC
公元	DAA GZS
公公	DAA DAA
公共	DAA FDO
公務	DAA DKO
公升	DAA AWQ
公司	DAA QHQ
公園	DAA KZS
公安	DAA HCQ
公寓	DAA GKU
公幹	DAA DCS
公廁	DAA THS
公式	DAA AWT
公映	DAA HSA
公會	DAA JOI
公有	DAA KYN
公正	DAA XUS
公民	DAA DVE
公法	DAA A9P
公演	DAA LGR
公營	DAA LUG
公爵	DAA NPT
公理	DAA IHR
公益	DAA HUX
公社	DAA ZOR
公私	DAA QGQ
公立	DAA I1T
公職	DAA XWT
公證	DAA XWS
公路	DAA ILC
公開	DAA ETQ
共同	FDO GAA
兵力	ASI IWT
兵器	ASI EGA
兵團	ASI GCG
具備	FKU CGK
具有	FKU KYN
具體	FKU FMR
典型	EFR JVQ
典故	EFR DLC
典禮	EFR IMR
典範	EFR C9N
典籍	EFR PUT
典雅	EFR GNR
再會	NTS JOI
再現	NTS JFS
再生	NTS VSQ
再者	NTS XOR
冤家	HZS DNQ
冥想	DVA QPR
冬天	ECA FFQ
冬季	ECA DGM
冬瓜	ECA DNG
冬至	ECA XGS
冰塊	AWI ESI
冰山	AWI VEQ
冰川	AWI YGG
冰箱	AWI QPQ
冰糖	AWI GQQ
冰雪	AWI QGJ
冰雹	AWI CED
冶金	LOR D1Y
准許	XVH IJD
凋謝	EHQ ROS
凌亂	IWQ ICI
凌駕	IWQ DNS
凜冽	I1R IGT
凡是	C9M ZFR
凡間	C9M DES
凶兆	IDM LIR
凹陷	H6T J6S
刀具	EKQ FKU
刀鋒	EKQ BDM
刊物	ECQ DXP
刊登	ECQ EXQ
刑期	JVQ FHC
刑法	JVQ A9P
刑罰	JVQ CZP
刑警	JVQ DSZ
列表	IGT AIJ
初中	TJQ JBA
初冬	TJQ ECA
初夜	TJQ LOS
初戀	TJQ IGI
初期	TJQ FHC
初步	TJQ CLC
初秋	TJQ OYA
初級	TJQ D1B
初賽	TJQ QTS
判刑	BCC JVQ
判定	BCC GVS
別人	CGL CVQ
別名	CGL DUE
別墅	CGL ZJR
別字	CGL PHS
別致	CGL JGS
利器	IGS EGA
利害	IGS JOS
利息	IGS QWT
利潤	IGS CVI
利用	IGS LDC
利益	IGS HUX
利落	IGS IQT
刪減	VDQ D6R
到位	EKS KGQ
到來	EKS ITQ
到場	EKS LPQ
到底	EKS EMR
到訪	EKS BPO
制服	XNS CBP
制止	XNS XHR
制衡	XNS JRQ
刻意	EXT HHE
刻板	EXT ADB
剃刀	FMS EKQ
削弱	QPT CPT
剋星	EXT QVQ
前人	PFQ CVQ
前夕	PFQ RUT
前天	PFQ FFQ
前奏	PFQ NZC
前往	PFQ KPT
前日	PFQ CVT
前景	PFQ DSZ
前期	PFQ FHC
前瞻	PFQ X4Q
前端	PFQ ECG
前線	PFQ QGS
前者	PFQ XOR
前言	PFQ GZC
前途	PFQ GLA
前進	PFQ NVS
前邊	PFQ AFA
前鋒	PFQ BDM
前面	PFQ DGG
前頭	PFQ GZA
剛勁	DQQ DUW
剪報	NGR AKC
剪影	NGR HSZ
剪接	NGR N4T
剪輯	NGR P1T
割裂	DCT IGT
割讓	DCT CPS
劃一	JTJ HVX
劇團	FSB GCG
劇場	FSB LPQ
劇壇	FSB GCQ
劇情	FSB PUQ
劇本	FSB AAB
劇烈	FSB IGT
劇照	FSB XIS
力圖	IWT GLA
力學	IWT JED
力挫	IWT NLI
力氣	IWT EIE
力求	IWT FYM
力爭	IWT STQ
功利	DAA IGS
功力	DAA IWT
功效	DAA JJS
功用	DAA LDC
功課	DAA ELI
加以	DNQ LHR
加倍	DNQ CSB
加入	DNQ C1T
加劇	DNQ FSB
加工	DNQ DAA
加強	DNQ FPC
加快	DNQ ERI
加油	DNQ LYA
加深	DNQ A1Q
加熱	DNQ CGT
加碼	DNQ DNB
加緊	DNQ DVV
加薪	DNQ QVQ
加速	DNQ QAD
助手	UJS AYB
助理	UJS IHR
努力	HLB IWT
勁敵	DUW GVT
勁旅	DUW IJR
勇敢	LDB D3R
勇氣	LDB EIE
勉強	DGJ FPC
動人	GAB CVQ
動力	GAB IWT
動員	GAB KXS
動容	GAB LDA
動工	GAB DAA
動感	GAB D2R
動態	GAB FTS
動手	GAB AYB
動搖	GAB LIQ
動機	GAB DIC
動物	GAB DXP
動用	GAB LDC
動詞	GAB RHQ
動議	GAB GFA
動輒	GAB J4T
動靜	GAB PUR
勘察	E2S TET
勘探	E2S F2Q
勘測	E2S TWT
務實	DKO BVT
募捐	DLC LGG
募集	DLC P1T
勢力	ANS IWT
勢必	ANS AVH
勢頭	ANS GZA
勤勉	FYC DGJ
勤快	FYC ERI
勵志	INS XHS
勸勉	EZU DGJ
包含	AJA J2Q
包容	AJA LDA
包括	AJA DCJ
包機	AJA DIC
包紮	AJA SET
包裝	AJA SPQ
包銷	AJA QIQ
化學	INI JED
化工	INI DAA
化石	INI ZUT
化身	INI AVQ
化驗	INI G4A
北極	AXD FWF
北邊	AXD AFA
匱乏	FGQ C9P
匹配	BVH BSC
匾額	AFB GRT
匿名	MWT DUE
千古	OFQ DLB
千萬	OFQ DZO
千金	OFQ D1Y
升旗	AWQ FHC
升溫	AWQ HAG
升級	AWQ D1B
升職	AWQ XWT
午睡	GLB ZFI
午餐	GLB OCQ
半價	ACC DNS
半夜	ACC LOS
半天	ACC FFQ
半死	ACC QGR
半途	ACC GLA
半邊	ACC AFA
卑劣	AFE IGJ
卑微	AFE DIM
卑賤	AFE PGS
協力	J5T IWT
協助	J5T UJS
協同	J5T GAA
協商	J5T APQ
協定	J5T GVS
協會	J5T JOI
協辦	J5T CEC
南北	H2Q AXD
南極	H2Q FWF
南瓜	H2Q DNG
博士	AQD UHR
博弈	AQD LUT
博愛	AQD HTS
印發	HVW AZP
印章	HVW XPQ
印花	HVW ING
印製	HVW XNS
印證	HVW XWS
印象	HVW RPR
危及	GFO F1B
危害	GFO JOS
危急	GFO D1B
危機	GFO DIC
危殆	GFO GTR
危險	GFO I4Z
即刻	NWT EXT
即席	NWT RUT
即日	NWT CVT
即時	NWT ZHQ
卻步	EPF CLC
原來	GZS ITQ
原則	GZS NXT
原因	GZS HVU
原始	GZS AHR
原子	GZS NHR
原本	GZS AAB
原理	GZS IHR
原籍	GZS PUT
原諒	GZS IPS
原貌	GZS DJC
厲害	INS JOS
及早	F1B NKR
及時	F1B ZHQ
及第	F1B GMS
及至	F1B XGS
友人	KYN CVQ
友善	KYN ZGR
友愛	KYN HTS
友誼	KYN GFA
叔叔	ABD ABD
受制	ZYB XNS
受困	ZYB EAI
受孕	ZYB LWS
受害	ZYB JOS
受審	ZYB A1R
受惠	ZYB JMI
受挫	ZYB NLI
受損	ZYB QAH
受熱	ZYB CGT
受用	ZYB LDC
受益	ZYB HUX
受聘	ZYB BUG
受虐	ZYB GPF
受訓	ZYB IXU
受託	ZYB FQT
受訪	ZYB BPO
受賄	ZYB ISH
叛亂	CCC ICI
叛逆	CCC GSB
叢林	PAA I1Q
口吻	EZB DXN
口味	EZB DIO
口岸	EZB GCS
口感	EZB D2R
口水	EZB AGH
口琴	EZB F1Y
口碑	EZB AFI
口福/口腹	EZB ABP
口紅	EZB JAA
口罩	EZB JJS
口腔	EZB EEA
口袋	EZB GTS
口角	EZB DED
口訣	EZB DFJ
口述	EZB BVJ
口音	EZB H1Y
叩頭/口頭	EZB GZA
古人	DLB CVQ
古代	DLB GTS
古典	DLB EFR
古塔	DLB F3T
古墓	DLB DLC
古板	DLB ADB
古物	DLB DXP
古玩	DLB GCI
古琴	DLB F1Y
古箏	DLB STQ
古籍	DLB PUT
古老	DLB IKR
古舊	DLB FYO
古董	DLB EAB
古裝	DLB SPQ
古詩	DLB AHQ
古蹟	DLB NUT
召開	LIS ETQ
召集	LIS P1T
可人	ELR CVQ
可以	ELR LHR
可信	ELR QVS
可口	ELR EZB
可悲	ELR AGI
可惜	ELR QUT
可愛	ELR HTS
可憐	ELR IFQ
可是	ELR ZFR
可疑	ELR GHC
可謂	ELR KIU
可靠	ELR EKS
史前	VHR PFQ
史學	VHR JED
史實	VHR BVT
史籍	VHR PUT
司儀	QHQ GFY
司機	QHQ DIC
司法	QHQ A9P
各個	DQT DLS
各自	DQT PGS
吉利	DVX IGS
吉祥	DVX RPQ
同一	GAA HVX
同化	GAA INI
同學	GAA JED
同年/童年	GAA HFQ
同志	GAA XHS
同性	GAA QUS
同情	GAA PUQ
同意	GAA HHE
同時	GAA ZHQ
同期	GAA FHC
同業	GAA G8F
同步	GAA CLC
同等	GAA EXR
同鄉	GAA IPC
同類	GAA IGI
名人	DUE CVQ
名冊	DUE TTT
名利	DUE IGS
名城	DUE ZUQ
名堂	DUE GQQ
名字	DUE PHS
名家	DUE DNQ
名山	DUE VEQ
名師	DUE VGQ
名流	DUE IYA
名片	DUE BFC
名義	DUE GFA
名詞	DUE RHQ
名額	DUE GRT
君主	DXS XKH
君子	DXS NHR
吝嗇	IVS VWT
含意	J2Q HHE
含義	J2Q GFA
吸引	I1B LVR
吸管	I1B DCH
吸納	I1B H2T
吸附	I1B CKO
呢喃	MGQ M6Q
周全	XYA PGG
周會	XYA JOI
周遊	XYA LYA
味精	DIO NUQ
味道	DIO GKR
呼吸	ILA I1B
呼喚	ILA ICI
呼救	ILA DYO
呼籲	ILA LKI
命名	DSK DUE
命案	DSK HCS
命運	DSK KXU
咆哮	CJA IJQ
咨詢	NGQ QVG
咫尺	XFR YUT
哀愁	HTQ UYA
品味	B1J DIO
品嘗	B1J ZPQ
品德	B1J EXT
品性	B1J QUS
品類	B1J IGI
員工	KXS DAA
哥哥	DLQ DLQ
哭泣	EAD E1B
哭訴	EAD QLC
哮喘	IJQ YGH
哲學	JGT JED
哲理	JGT IHR
哺乳	CLC CKH
唐樓	GQQ IZA
唐突	GQQ GAJ
售價	ZYC DNS
售罄	ZYC EVS
售賣	ZYC DPC
唱功	YPS DAA
唱曲	YPS EDP
唱機	YPS DIC
唱歌	YPS DLQ
唱片	YPS BFC
唱腔	YPS EEA
唾沫	FLI DCD
商人	APQ CVQ
商務	APQ DKO
商品	APQ B1J
商場	APQ LPQ
商家	APQ DNQ
商店	APQ E5S
商旅	APQ IJR
商會	APQ JOI
商業	APQ G8F
商機	APQ DIC
商界	APQ DQS
商船	APQ BGG
商談	APQ G3Q
商販	APQ AZO
商貿	APQ DZC
問鼎	DXO EVR
善心	ZGR Q1Q
善本	ZGR AAB
善款	ZGR ECH
善良	ZGR IPQ
喉嚨	JZA IAA
喉頭	JZA GZA
喘息	YGH QWT
喚起	ICI EHD
喜劇	IHD FSB
喜宴	IHD HFS
喜悅	IHD LGJ
喜愛	IHD HTS
喜慶	IHD ESA
喜歡	IHD ICG
嘈雜	PKQ P2T
嘉許	DNQ IJD
嘗試	ZPQ AHS
嘮叨	KJQ FKQ
嘲諷	JJQ ABO
噁心	HLC Q1Q
器官	EGA DCG
器材	EGA PTQ
器皿	EGA DSJ
嚴厲	G8C INS
嚴密	G8C DVL
嚴寒	G8C JCQ
嚴峻	G8C QVI
嚴懲	G8C LWQ
嚴肅	G8C QBD
嚴苛	G8C JLQ
嚴謹	G8C DYD
囊括	HQQ DCJ
囚犯	RYA C9N
四周	QGS XYA
四季	QGS DGM
四時	QGS ZHQ
四肢	QGS XFQ
四面	QGS DGG
回來	JSG ITQ
回升	JSG AWQ
回味	JSG DIO
回報	JSG AKC
回憶	JSG HWF
回暖	JSG HCH
回歸	JSG DIS
回流	JSG IYA
回程	JSG LUQ
回答	JSG E2T
回落	JSG IQT
回響	JSG IPD
回頭	JSG GZA
回顧	JSG DLC
回饋	JSG FGQ
因循	HVU RVG
因果	HVU DLH
因此	HVU OFR
因由	HVU LYA
因素	HVU QLC
因緣/姻緣	HVU LGG
因而	HVU CHQ
困境	EAI DSZ
困惑	EAI JXJ
困擾	EAI CIR
困窘	EAI FVP
困頓	EAI EAI
固執	DLC X1T
固定	DLC GVS
固態	DLC FTS
固有	DLC KYN
固然	DLC CGQ
固體	DLC FMR
國務	DXJ DKO
國境	DXJ DSZ
國學	DXJ JED
國家	DXJ DNQ
國寶	DXJ AKB
國庫	DXJ ELC
國情	DXJ PUQ
國慶	DXJ ESA
國會	DXJ JOI
國有	DXJ KYN
國歌	DXJ DLQ
國民	DXJ DVE
國營	DXJ LUG
國界	DXJ DQS
國立	DXJ I1T
國籍	DXJ PUT
國粹	DXJ QGI
國道	DXJ GKR
國際	DXJ NNS
園地	KZS GGS
園藝	KZS GNW
圓形	KGO JVQ
圓滿	KGO DCB
圓潤	KGO CVI
圓盤	KGO CCA
圖形	GLA JVQ
圖書	GLA AJQ
圖案	GLA HCS
圖片	GLA BFC
圖章	GLA XPQ
圖紙	GLA XFR
圖騰	GLA GXQ
團員	GCG KXS
團圓	GCG KGO
團結	GCG DFT
團隊	GCG GSI
團體	GCG FMR
地主	GGS XKH
地位	GGS KGQ
地勢	GGS ANS
地勤	GGS FYC
地名	GGS DUE
地圖	GGS GLA
地址	GGS XHR
地域	GGS KWR
地基	GGS DHC
地層	GGS PXQ
地帶	GGS EOS
地形	GGS JVQ
地支	GGS XFQ
地板	GGS ADB
地步	GGS CLC
地段	GGS GCI
地毯	GGS F3R
地獄	GGS GDP
地球	GGS FYM
地理	GGS IHR
地皮	GGS CFI
地盤	GGS CCA
地租	GGS NLA
地表	GGS AIJ
地貌	GGS DJC
地道	GGS GKR
地鐵	GGS FFT
地震	GGS XVS
地面	GGS DGG
地點	GGS E5R
均勻	DVK LVG
均衡	DVK JRQ
坑人	ERQ CVQ
坦克	FCR EXT
坦承	FCR ZWQ
坦然	FCR CGQ
坦言	FCR GZC
坦誠	FCR ZUQ
垂死	ZFG QGR
垂淚	ZFG IGI
垂直	ZFG LWT
垂老	ZFG IKR
垂釣	ZFG EHS
埋葬	DQA NQS
城堡	ZUQ AKB
城市	ZUQ ZHR
城牆	ZUQ PPQ
城鄉	ZUQ IPC
城門	ZUQ DAA
執導	X1T GKS
執掌	X1T XPR
執業	X1T G8F
執照	X1T XIS
執筆	X1T AVL
基因	DHC HVU
基地	DHC GGS
基層	DHC PXQ
基建	DHC DZE
基本	DHC AAB
基石	DHC ZUT
基礎	DHC TJR
基金	DHC D1Y
基點	DHC E5R
堂兄	GQQ ISO
堂妹	GQQ DSC
堂姐	GQQ NOR
堂皇	GQQ JQG
堅固	DFQ DLC
堅定	DFQ GVS
堅實	DFQ BVT
堅強	DFQ FPC
堅忍	DFQ CVR
堅持	DFQ LHQ
堅毅	DFQ GIE
堅硬	DFQ GTS
堅貞	DFQ JUQ
堆砌	ESG OMS
堡壘	AKB IGH
報價	AKC DNS
報刊	AKC ECQ
報名	AKC DUE
報失	AKC AVT
報應	AKC HWE
報時	AKC ZHQ
報案	AKC HCS
報稅	AKC ANI
報章	AKC XPQ
報紙	AKC XFR
報表	AKC AIJ
報警	AKC DSZ
報道	AKC GKR
報酬	AKC ZYA
報關	AKC DDG
報館	AKC DCI
場地	LPQ GGS
場所	LPQ VJR
場景	LPQ DSZ
場次	LPQ OGS
場面	LPQ DGG
場館	LPQ DCI
塑像	QLC RPR
塵埃	LVQ HTQ
境地	DSZ GGS
境界	DSZ DQS
墓地	DLC GGS
墓碑	DLC AFI
墓穴	DLC JFJ
墓葬	DLC NQS
墨跡	DXD NUT
墨鏡	DXD DSA
墨魚	DXD GJC
壁虎	AVD ILB
壓制	H7T XNS
壓力	H7T IWT
壓抑	H7T HWB
壓榨	H7T SNS
壓縮	H7T VBD
壓迫	H7T ARD
壕溝	JKQ DZA
壘球	IGH FYM
士兵	UHR ASI
壯年	SPS HFQ
壯舉	SPS DJD
壯闊	SPS ECJ
夕陽	RUT LPQ
外交	GOI DJQ
外人	GOI CVQ
外來	GOI ITQ
外公	GOI DAA
外力	GOI IWT
外勤	GOI FYC
外商	GOI APQ
外國	GOI DXJ
外地	GOI GGS
外形/外型	GOI JVQ
外婆	GOI CLA
外幣	GOI CNG
外界	GOI DQS
外籍	GOI PUT
外表	GOI AIJ
外貌	GOI DJC
外貿	GOI DZC
外資	GOI NGQ
外遇	GOI GKU
外邊	GOI AFA
外銷	GOI QIQ
外面	GOI DGG
多元	ELQ GZS
多謝	ELQ ROS
多餘	ELQ LJQ
多麼	ELQ DLB
夜宵	LOS QIQ
夜幕	LOS DQD
夜晚	LOS DZN
夜色	LOS VWT
夜間	LOS DES
天亮	FFQ IPS
天倫	FFQ IVG
天地	FFQ GGS
天堂	FFQ GQQ
天子	FFQ NHR
天帝	FFQ EMS
天性	FFQ QUS
天意	FFQ HHE
天才	FFQ PTQ
天文	FFQ DXM
天明	FFQ DSI
天時	FFQ ZHQ
天橋	FFQ FIY
天機	FFQ DIC
天淵	FFQ HFG
天災	FFQ NTQ
天然	FFQ CGQ
天理	FFQ IHR
天生	FFQ VSQ
天空	FFQ EAA
天籟	FFQ IOS
天職	FFQ XWT
天花	FFQ ING
天賦	FFQ AKO
天際	FFQ NNS
天體	FFQ FMR
天鵝	FFQ GLQ
太太	FOS FOS
太極	FOS FWF
太空	FOS EAA
太陽	FOS LPQ
央求	HPC FYM
失主	AVT XKH
失修	AVT QYA
失利	AVT IGS
失地	AVT GGS
失實	AVT BVT
失常	AVT ZPQ
失意	AVT HHE
失戀	AVT IGI
失手	AVT AYB
失明	AVT DSI
失業	AVT G8F
失眠	AVT DFA
失禮	AVT IMR
失竊	AVT OFT
失職	AVT XWT
失色	AVT VWT
失落	AVT IQT
失衡	AVT JRQ
失誤	AVT GLC
失蹤	AVT NDA
夾擊	D6T DVT
夾道	D6T GKR
奉命	CDN DSK
奉陪	CDN CSA
奏效	NZC JJS
奢侈	AOQ YFR
奢靡	AOQ DFJ
奪得	GCJ EXT
奪目	GCJ DBP
奮力	AXO IWT
奮發	AXO AZP
奮鬥	AXO EZC
奴婢	HLA CFF
奴隸	HLA IMS
妄想	DPO QPR
妒忌	ELC FHE
妙齡	DIG IVQ
妥協	FLH J5T
妥善	FLH ZGR
妥貼	FLH F5T
妹妹	DSC DSC
姆指	DZC XGR
始祖	AHR NLB
始終	AHR XBA
姐妹	NOR DSC
姐姐	NOR NOR
姑丈	DLA LPR
姑娘	DLA MPQ
姑息	DLA QWT
姑母	DLA DZB
姓名	QUS DUE
姥姥/媽媽	DLB DLB
姨媽	LGQ DLB
姿勢	NGQ ANS
姿態	NGQ FTS
威信	HIS QVS
威力	HIS IWT
威嚴	HIS G8C
娃娃	HPQ HPQ
娟秀	HGK QYC
婆婆	CLA CLA
婚姻	IAG HVU
婚嫁	IAG DNS
婚宴	IAG HFS
婚禮	IAG IMR
婚紗	IAG VNQ
媒介	DSA DQS
媒體	DSA FMR
媲美	BMC DGJ
嫁妝	DNS SPQ
嫉妒	PVT ELC
嫌棄	J5Q EGW
嫌疑	J5Q GHC
嫣紅	HGY JAA
嫵媚	DKN DGK
嬋娟	ZGQ HGK
嬰孩	HUU JTQ
子夜	NHR LOS
子孫	NHR QAG
子宮	NHR DBM
孔廟	EAB DIK
孔教	EAB DJS
孔雀	EAB NPT
孕婦	LWS CYN
字帖	PHS F5T
字幕	PHS DQD
字形	PHS JVQ
字條	PHS GHQ
字母	PHS DZB
字眼	PHS GER
字詞	PHS RHQ
字跡	PHS NUT
字音	PHS H1Y
字體	PHS FMR
存心	PAG Q1Q
存檔	PAG EQQ
存款	PAG ECH
存貨	PAG ILI
孝子	IJS NHR
孝敬	IJS DSA
季刊	DGM ECQ
季節	DGM NFT
季軍	DGM DXS
孤寂	DLA PVT
孤獨	DLA GAD
孤立	DLA I1T
孩子	JTQ NHR
孩童	JTQ GAA
孫子	QAG NHR
孵化	BKM INI
學位	JED KGQ
學制	JED XNS
學員	JED KXS
學問	JED DXO
學堂	JED GQQ
學士	JED UHR
學子	JED NHR
學年	JED HFQ
學府	JED AKN
學徒	JED GLA
學期	JED FHC
學業	JED G8F
學歷	JED IVT
學派	JED BPC
學童	JED GAA
學習	JED R1T
學者	JED XOR
學術	JED BVJ
宇宙	KKT LYC
宇航	KKT JQQ
安全	HCQ PGG
安定	HCQ GVS
安寧	HCQ HVQ
安心	HCQ Q1Q
安息	HCQ QWT
安慰	HCQ HIU
安排	HCQ CQA
安撫	HCQ BKN
安然	HCQ CGQ
安穩	HCQ HAH
安置	HCQ JHS
安葬	HCQ NQS
安裝	HCQ SPQ
安逸	HCQ LVT
安靜	HCQ PUR
安頓	HCQ EAI
完備	JCG CGK
完全	JCG PGG
完善	JCG ZGR
完成	JCG ZUQ
完整	JCG XUR
完滿	JCG DCB
完畢	JCG AVH
完結	JCG DFT
完美	JCG DGJ
宏偉	JTG KIT
宏揚	JTG LPQ
宏願	JTG GZU
宗師	NCA VGQ
宗族	NCA PAD
宗旨	NCA XGR
官兵	DCG ASI
官司	DCG QHQ
官吏	DCG IHS
官員	DCG KXS
官場	DCG LPQ
官邸	DCG EMR
宜人	GFY CVQ
客串	ERT DDI
客人	ERT CVQ
客廳	ERT FVQ
客機	ERT DIC
客船	ERT BGG
客輪	ERT IVG
客運	ERT KXU
宣判	QGG BCC
宣揚	QGG LPQ
宣紙	QGG XFR
宣言	QGG GZC
宣誓	QGG ZNS
室溫	AVT HAG
害羞	JOS QYA
家人	DNQ CVQ
家務	DNQ DKO
家園	DNQ KZS
家境	DNQ DSZ
家屬	DNQ ZDD
家常	DNQ ZPQ
家庭	DNQ GVQ
家族	DNQ PAD
家眷	DNQ DGQ
家禽	DNQ F1Y
家計	DNQ DMS
家鄉	DNQ IPC
家門	DNQ DAA
容器	LDA EGA
容納	LDA H2T
容許	LDA IJD
容貌	LDA DJC
寂寞	PVT DQD
寂靜	PVT PUR
寄存	DFA PAG
寄生	DFA VSQ
寄託	DFA FQT
密切	DVL OFT
密碼	DVL DNB
密集	DVL P1T
富商	AYO APQ
富有	AYO KYN
富裕	AYO LKI
富豪	AYO JKQ
富貴	AYO DIU
寒意	JCQ HHE
寒暄	JCQ IZS
寒流	JCQ IYA
寓意	GKU HHE
寓所	GKU VJR
寡婦	DNH CYN
寡頭	DNH GZA
寢室	O1R AVT
實例	BVT INS
實力	BVT IWT
實務	BVT DKO
實地	BVT GGS
實情	BVT PUQ
實物	BVT DXP
實現	BVT JFS
實用	BVT LDC
實習	BVT R1T
實證	BVT XWS
實踐	BVT PGR
實際	BVT NNS
實驗	BVT G4A
實體	BVT FMR
寧靜	HVQ PUR
審判	A1R BCC
審批	A1R BMA
審結	A1R DFT
審美	A1R DGJ
審計	A1R DMS
審訊	A1R QVS
審議	A1R GFA
審閱	A1R LGJ
寫實	QOR BVT
寫意	QOR HHE
寫法	QOR A9P
寫照	QOR XIS
寫生	QOR VSQ
寬容	ECG LDA
寬恕	ECG AJS
寬裕	ECG LKI
寬闊	ECG ECJ
寬限	ECG JER
寬頻	ECG CVE
寮屋	IHQ HAD
寵愛	KDB HTS
寵物	KDB DXP
寶寶	AKB AKB
寶座	AKB PLI
寶玉	AKB GDP
寶石	AKB ZUT
寶貝	AKB AOC
寶貴	AKB DIU
寺廟	RHS DIK
專人	XGG CVQ
專利	XGG IGS
專制	XGG XNS
專員	XGG KXS
專家	XGG DNQ
專心	XGG Q1Q
專政	XGG XUS
專案	XGG HCS
專業	XGG G8F
專櫃	XGG FGQ
專欄	XGG ICQ
專注	XGG XKI
專營	XGG LUG
專用	XGG LDC
專線	XGG QGS
專訪	XGG BPO
專責	XGG STT
專賣	XGG DPC
專輯	XGG P1T
專門	XGG DAA
專項	XGG JEB
尊嚴	NAG G8C
尊崇	NAG UBA
尊敬	NAG DSA
尊貴	NAG DIU
尋常	R1Q ZPQ
尋求	R1Q FYM
尋獲	R1Q JTJ
尋覓	R1Q DVD
對付	ESI AKO
對壘	ESI IGH
對外	ESI GOI
對峙	ESI LHR
對待	ESI GTR
對手	ESI AYB
對流	ESI IYA
對照	ESI XIS
對白	ESI CRD
對立	ESI I1T
對話	ESI JRI
對談	ESI G3Q
對象	ESI RPR
對面	ESI DGG
導師	GKS VGQ
導演	GKS LGR
導管	GKS DCH
導致	GKS JGS
導言	GKS GZC
導讀	GKS GAD
導遊	GKS LYA
小丑	QIR KYB
小人	QIR CVQ
小兒	QIR CFQ
小品	QIR B1J
小型	QIR JVQ
小姐	QIR NOR
小子	QIR NHR
小學	QIR JED
小巴	QIR ANA
小心	QIR Q1Q
小時	QIR ZHQ
小組	QIR NLB
小腿	QIR FSH
小販	QIR AZO
小麥	QIR DTD
尖叫	N4Q DHS
尖端	N4Q ECG
就地	PYC GGS
就學	PYC JED
就寢	PYC O1R
就是	PYC ZFR
就業	PYC G8F
就此	PYC OFR
就算	PYC QCH
就範	PYC C9N
就緒	PYC RJR
就讀	PYC GAD
就醫	PYC HHC
尺子	YUT NHR
尺碼	YUT DNB
尼姑	MGQ DLA
尾巴	DIN ANA
尾聲	DIN AUQ
尿液	HHS LUT
局勢	FDP ANS
局限	FDP JER
局面	FDP DGG
屁股	BGG DLB
屆時	DQS ZHQ
屆滿	DQS DCB
屋子	HAD NHR
屋宇	HAD KKT
屋脊	HAD NUT
屋頂	HAD EVR
展位	JGR KGQ
展品	JGR B1J
展期	JGR FHC
展現	JGR JFS
展覽	JGR I3R
展銷	JGR QIQ
展開	JGR ETQ
展露	JGR ILC
展館	JGR DCI
層次	PXQ OGS
層面	PXQ DGG
履歷	IGR IVT
屬性	ZDD QUS
山丘	VEQ EYM
山地	VEQ GGS
山坡	VEQ BLA
山城	VEQ ZUQ
山巒	VEQ ICG
山村	VEQ OAG
山楂	VEQ UNQ
山水	VEQ AGH
山火	VEQ ILH
山路	VEQ ILC
山頭	VEQ GZA
屹立	GYF I1T
岳母	GED DZB
峻峭	QVI OIS
崇拜	UBA AQC
崗位	DQQ KGQ
崛起	FXV EHD
崩潰	AXA JSI
巡禮	RVG IMR
巡遊	RVG LYA
巡邏	RVG ILS
工人	DAA CVQ
工具	DAA FKU
工匠	DAA PPS
工地	DAA GGS
工時	DAA ZHQ
工業	DAA G8F
工程	DAA LUQ
工藝	DAA GNW
工資	DAA NGQ
左手	NLR AYB
左邊	NLR AFA
巨人	FJD CVQ
巨匠	FJD PPS
巨型	FJD JVQ
巨星	FJD QVQ
巨款	FJD ECH
巨變	FJD AGK
巨響	FJD IPD
巨頭	FJD GZA
巴士	ANA UHR
市井	ZHR NUR
市價	ZHR DNS
市場	ZHR LPQ
市容	ZHR LDA
市政	ZHR XUS
市民	ZHR DVE
市郊	ZHR DJQ
市集	ZHR P1T
市面	ZHR DGG
帝國	EMS DXJ
師傅	VGQ AKO
師兄	VGQ ISO
師妹	VGQ DSC
師姐	VGQ NOR
師徒	VGQ GLA
師範	VGQ C9N
師資	VGQ NGQ
帳篷	JPS CAA
帶動	EOS GAB
帶子	EOS NHR
帶領	EOS IUR
帶頭	EOS GZA
常務	ZPQ DKO
常年	ZPQ HFQ
常態	ZPQ FTS
常理	ZPQ IHR
常規	ZPQ DFK
常駐	ZPQ JKI
帽子	DKC NHR
幌子	JQH NHR
幕牆	DQD PPQ
幣值	CNG LHS
幣制	CNG XNS
幫助	AQA UJS
幫忙	AQA DQA
干擾	DCQ CIR
干預	DCQ LJS
年代	HFQ GTS
年份	HFQ AVI
年初	HFQ TJQ
年夜	HFQ LOS
年尾	HFQ DIN
年幼	HFQ H0W
年底	HFQ EMR
年息	HFQ QWT
年曆	HFQ IVT
年紀	HFQ DHD
年級	HFQ D1B
年終	HFQ XBA
年老	HFQ IKR
年薪	HFQ QVQ
年表	HFQ AIJ
年貨	HFQ ILI
年資	HFQ NGQ
年輪	HFQ IVG
年邁	HFQ DRC
年間	HFQ DES
年齡	HFQ IVQ
幸免	JTR DGJ
幸福	JTR ABP
幸而	JTR CHQ
幸虧	JTR EFO
幸運	JTR KXU
幹線	DCS QGS
幹練	DCS IFS
幻化	JEI INI
幻影	JEI HSZ
幻想	JEI QPR
幻滅	JEI DGH
幻燈	JEI EXQ
幻象	JEI RPR
幼年	H0W HFQ
幼稚	H0W LGS
幼苗	H0W DII
幽暗	H0U H2S
幽雅	H0U GNR
幽靈	H0U IVQ
幽香	H0U IPC
幽默	H0U DXD
庇佑	AGG KYO
庇護	AGG JLC
床頭	UPQ GZA
序列	RJR IGT
序幕	RJR DQD
序曲	RJR EDP
底層	EMR PXQ
底片	EMR BFC
底盤	EMR CCA
底線	EMR QGS
底薪	EMR QVQ
底蘊	EMR HXS
店主	E5S XKH
店面	E5S DGG
座位	PLI KGQ
座談	PLI G3Q
庫存	ELC PAG
康泰	EQQ FOS
廂房	QPQ CPM
廉價	I4Q DNS
廉署	I4Q ZJS
廚具	LKG FKU
廚師	LKG VGQ
廚房	LKG CPM
廚藝	LKG GNW
廟宇	DIK KKT
廢棄	AUO EGW
廢水	AUO AGH
廢物	AUO DXP
廢紙	AUO XFR
廣博	DQH AQD
廣場	DQH LPQ
廣播	DQH ALC
廣義	DQH GFA
廣袤	DQH DZC
廣闊	DQH ECJ
廳堂	FVQ GQQ
建國	DZE DXJ
建材	DZE PTQ
建構	DZE DZC
建立	DZE I1T
建築	DZE JBD
建設	DZE AGT
建議	DZE GFA
式微	AWT DIM
弓箭	DBM NGS
引入	LVR C1T
引力	LVR IWT
引文	LVR DXM
引渡	LVR GLC
引用	LVR LDC
引發	LVR AZP
引證	LVR XWS
引起	LVR EHD
引述	LVR BVJ
引退	LVR FSI
引領	LVR IUR
弘揚	JXG LPQ
弧形	JLA JVQ
弱勢	CPT ANS
弱智	CPT JFS
弱點	CPT E5R
強健	FPC FZE
強制	FPC XNS
強勁	FPC DUW
強勢	FPC ANS
強化	FPC INI
強壯	FPC SPS
強弱	FPC CPT
強烈	FPC IGT
強盜	FPC GKS
強硬	FPC GTS
強身	FPC AVQ
彌補	DFE ALB
彎曲	HDG EDP
彎腰	HDG HIU
形制	JVQ XNS
形勢	JVQ ANS
形容	JVQ LDA
形式	JVQ AWT
形態	JVQ FTS
形成	JVQ ZUQ
形狀	JVQ UPS
形象	JVQ RPR
形體	JVQ FMR
彩色	OTR VWT
彩雲	OTR KXS
影像	HSZ RPR
影印	HSZ HVW
影子	HSZ NHR
影展	HSZ JGR
影星	HSZ QVQ
影片	HSZ BFC
影迷	HSZ DMA
影響	HSZ IPD
彼此	AFJ OFR
往來	KPT ITQ
往常	KPT ZPQ
往往	KPT KPT
往昔	KPT QUT
往返	KPT AZN
征戰	XUQ XGS
征服	XUQ CBP
待遇	GTR GKU
律師	IVJ VGQ
徒步	GLA CLC
徒然	GLA CGQ
得主	EXT XKH
得以	EXT LHR
得到	EXT EKS
得失	EXT AVT
得宜	EXT GFY
得悉	EXT QVT
得意	EXT HHE
得手	EXT AYB
得益	EXT HUX
得體	EXT FMR
徘徊	CSA JSG
徜徉	ZPQ LPQ
御用	GJE LDC
復發	CYO AZP
循環	RVG JDG
微型	DIM JVQ
微妙	DIM DIG
微小	DIM QIR
微弱	DIM CPT
微微	DIM DIM
微服	DIM CBP
微粒	DIM I1T
微薄	DIM CQD
德育	EXT LBD
徽章	IIS XPQ
心儀	Q1Q GFY
心動	Q1Q GAB
心地	Q1Q GGS
心境	Q1Q DSZ
心底	Q1Q EMR
心弦	Q1Q JFQ
心急	Q1Q D1B
心性	Q1Q QUS
心情	Q1Q PUQ
心意	Q1Q HHE
心態	Q1Q FTS
心房	Q1Q CPM
心扉	Q1Q AIM
心智	Q1Q JFS
心機	Q1Q DIC
心理	Q1Q IHR
心疼	Q1Q GCA
心痛	Q1Q FAC
心碎	Q1Q QSI
心緒	Q1Q RJR
心聲	Q1Q AUQ
心腸	Q1Q LPQ
心腹	Q1Q ABP
心血	Q1Q IFJ
心跡	Q1Q NUT
心路	Q1Q ILC
心軟	Q1Q CGH
心酸	Q1Q QCG
心醉	Q1Q NGI
心靈	Q1Q IVQ
心頭	Q1Q GZA
必備	AVH CGK
必定	AVH GVS
必然	AVH CGQ
必須/必需	AVH QKG
忌口	FHE EZB
忌諱	FHE IIU
忍受	CVR ZYB
忍心	CVR Q1Q
忍耐	CVR HTS
志願	XHS GZU
忘情	DPO PUQ
忘我	DPO GLR
忘記	DPO DHE
忙碌	DQA IAD
忠實	JBA BVT
忠烈	JBA IGT
忠誠	JBA ZUQ
忤逆	GLC GSB
快意	ERI HHE
快捷	ERI P4T
快艇	ERI GVR
快速	ERI QAD
快門	ERI DAA
快餐	ERI OCQ
念頭	H5S GZA
忽然	IAJ CGQ
忽略	IAJ IPT
急促	D1B ODD
急劇	D1B FSB
急忙	D1B DQA
急性	D1B QUS
急救	D1B DYO
急流	D1B IYA
急速	D1B QAD
急需	D1B QKG
性別	QUS CGL
性情	QUS PUQ
性感	QUS D2R
性狀	QUS UPS
怪物	DQI DXP
怪異	DQI LHS
怪誕	DQI GCR
怯懦	E8F CKG
恍惚	DQG IAJ
恍然	DQG CGQ
恢宏	ESG JTG
恩德	HBQ EXT
恩賜	HBQ QFS
恬靜	G5Q PUR
恭喜	DDM IHD
恭賀	DDM JLS
悄悄	OIR OIR
悄然	OIR CGQ
悅耳	LGJ CHR
悉心	QVT Q1Q
悚然	QDB CGQ
悠久	LYA DYN
悠揚	LYA LPQ
悠然	LYA CGQ
悠閒	LYA DEQ
患病	JDI CSK
患者	JDI XOR
悲劇	AGI FSB
悲哀	AGI HTQ
悲壯	AGI SPS
悲慘	AGI O2R
悲憫	AGI DVJ
悲痛	AGI FAC
悶熱	DAC CGT
情人	PUQ CVQ
情勢	PUQ ANS
情報	PUQ AKC
情境/情景	PUQ DSZ
情形	PUQ JVQ
情意	PUQ HHE
情感	PUQ D2R
情態	PUQ FTS
情慾	PUQ LDD
情懷	PUQ JQG
情敵	PUQ GVT
情書	PUQ AJQ
情歌	PUQ DLQ
情況	PUQ IPU
情節	PUQ NFT
情結	PUQ DFT
情緒	PUQ RJR
情緣	PUQ LGG
情義/情誼	PUQ GFA
情願	PUQ GZU
惆悵	KYA KPS
惜別	QUT CGL
惟有	LGG KYN
惟獨	LGG GAD
惠顧	JMI DLC
想像	QPR RPR
想必	QPR AVH
想法	QPR A9P
惶惑	JQG JXJ
惹火	COR ILH
愉快	LKG ERI
愉悅	LKG LGJ
意味	HHE DIO
意圖	HHE GLA
意境	HHE DSZ
意外	HHE GOI
意志	HHE XHS
意念	HHE H5S
意態	HHE FTS
意義	HHE GFA
意象	HHE RPR
意願	HHE GZU
愕然	GQT CGQ
愚弄	GKS IAC
愛人	HTS CVQ
愛國	HTS DXJ
愛心	HTS Q1Q
愛情	HTS PUQ
愛慕	HTS DLC
愛戀	HTS IGI
愛戴	HTS ETS
愛護	HTS JLC
愜意	E5T HHE
感人	D2R CVQ
感到	D2R EKS
感動	D2R GAB
感受	D2R ZYB
感官	D2R DCG
感性	D2R QUS
感恩	D2R HBQ
感悟	D2R GLC
感情	D2R PUQ
感慨	D2R ETS
感懷	D2R JQG
感知	D2R JFQ
感觸	D2R YDD
感謝	D2R ROS
慈善	PHQ ZGR
慈悲	PHQ AGI
慈母	PHQ DZB
慕名	DLC DUE
慘劇	O2R FSB
慘況	O2R IPU
慘烈	O2R IGT
慘痛	O2R FAC
慘白	O2R CRD
慢性	DDC QUS
慣常	DDI ZPQ
慣性	DDI QUS
慫恿	QDB LDB
慶典	ESA EFR
慶幸	ESA JTR
憂心	HYM Q1Q
憂患	HYM JDI
憂愁	HYM UYA
憂慮	HYM IJS
憂鬱	HYM HXV
憑空	CWI EAA
憔悴	PIQ PGI
憲法	IZE A9P
憲章	IZE XPQ
懂得	EAB EXT
應付	HWE AKO
應急	HWE D1B
應戰	HWE XGS
應用	HWE LDC
應考	HWE EKR
應聲	HWE AUQ
應變	HWE AGK
懦弱	CKG CPT
懲罰	LWQ CZP
懶得	ICR EXT
懷孕	JQG LWS
懷念	JQG H5S
懷抱	JQG CKB
懷疑	JQG GHC
懷舊	JQG FYO
懸掛	JFG DPI
懸殊	JFG ZKG
懸浮	JFG CYM
懸空	JFG EAA
戀人	IGI CVQ
戀情	IGI PUQ
戀愛	IGI HTS
戈壁	DLG AVD
成交	ZUQ DJQ
成人	ZUQ CVQ
成功	ZUQ DAA
成名	ZUQ DUE
成員	ZUQ KXS
成因	ZUQ HVU
成就	ZUQ PYC
成年	ZUQ HFQ
成效	ZUQ JJS
成本	ZUQ AAB
成果	ZUQ DLH
成熟	ZUQ ZBD
成立	ZUQ I1T
成績	ZUQ NVT
戒備	DQS CGK
戒心	DQS Q1Q
戒指	DQS XGR
戒毒	DQS GCD
或者	JXJ XOR
或許	JXJ IJD
戰亂	XGS ICI
戰友	XGS KYN
戰國	XGS DXJ
戰場	XGS LPQ
戰士	XGS UHR
戰役	XGS LUJ
戰機	XGS DIC
戰火	XGS ILH
戰爭	XGS STQ
戰略	XGS IPT
戰線	XGS QGS
戰績	XGS NVT
戰艦	XGS J7R
戰術	XGS BVJ
戰鬥	XGS EZC
所以	VJR LHR
所屬	VJR ZDD
所得	VJR EXT
所有	VJR KYN
所謂	VJR KIU
手冊	AYB TTT
手勢	AYB ANS
手工	AYB DAA
手帕	AYB DDD
手感	AYB D2R
手指	AYB XGR
手掌	AYB XPR
手杖	AYB LPR
手機	AYB DIC
手段	AYB GCI
手法	AYB A9P
手筆	AYB AVL
手續	AYB RDD
手腕	AYB HCI
手腳	AYB DPF
手臂	AYB AFG
手藝	AYB GNW
手術	AYB BVJ
手頭	AYB GZA
才子	PTQ NHR
才學	PTQ JED
才藝	PTQ GNW
扮演	AEC LGR
批准	BMA XVH
批判	BMA BCC
批發	BMA AZP
承包	ZWQ AJA
承受	ZWQ ZYB
承接	ZWQ N4T
承繼	ZWQ DMS
承襲	ZWQ R1T
承諾	ZWQ HQT
承辦	ZWQ CEC
承運	ZWQ KXU
技工	FFZ DAA
技師	FFZ VGQ
技法	FFZ A9P
技藝	FFZ GNW
技術	FFZ BVJ
抄襲	TJQ R1T
把握	ANB HED
把玩	ANB GCI
把門	ANB DAA
抑制	HWB XNS
抑或	HWB JXJ
抑鬱	HWB HXV
投保	GZA AKB
投入	GZA C1T
投寄	GZA DFA
投影	GZA HSZ
投機	GZA DIC
投注	GZA XKI
投考	GZA EKR
投胎	GZA FTQ
投訴	GZA QLC
投資	GZA NGQ
投身	GZA AVQ
抗戰	EQS XGS
抗菌	EQS FVP
抨擊	BTA DVT
抵制	EMR XNS
抵擋	EMR EQS
抵禦	EMR GJD
抵觸	EMR YDD
抵賴	EMR IOS
抵銷	EMR QIQ
抹煞	DCD VET
抹黑	DCD IXT
抽筋	KYA DYC
抽籤	KYA O4Q
抽象	KYA RPR
抽驗	KYA G4A
拉麵	I2T DFC
拋售	BJA ZYC
拋棄	BJA EGW
拍手	BRD AYB
拍板	BRD ADB
拍照	BRD XIS
拍賣	BRD DPC
拒絕	FJD PGJ
拖把	FLS ANB
拖欠	FLS E8E
拘捕	DKS CLC
拘謹	DKS DYD
招募	XIQ DLC
招呼	XIQ ILA
招商	XIQ APQ
招待	XIQ GTR
招攬	XIQ I3R
招租	XIQ NLA
招聘	XIQ BUG
招股	XIQ DLB
招致	XIQ JGS
拜師	AQC VGQ
拜託	AQC FQT
拯救	XWR DYO
拱形	DDN JVQ
拳擊	FGO DVT
拳腳	FGO DPF
拳頭	FGO GZA
拼命	BVA DSK
拼圖	AUE GLA
拼寫	AUE QOR
拼湊	AUE OZC
拼盤	AUE CCA
拼音	AUE H1Y
持久	LHQ DYN
持續	LHQ RDD
指南	XGR H2Q
指導	XGR GKS
指尖	XGR N4Q
指揮	XGR IIS
指明	XGR DSI
指甲	XGR D7T
指紋	XGR DXM
指證	XGR XWS
指責	XGR STT
按壓	HCS H7T
按摩	HCS DLA
按時	HCS ZHQ
按照	HCS XIS
按鈕	HCS MYB
挪用	HLQ LDC
挽回	DZN JSG
挾持	J5T LHQ
捉弄	SED IAC
捐助	LGG UJS
捐款	LGG ECH
捐贈	LGG PXS
捕捉	CLC SED
捕撈	CLC IKQ
捧場	BDN LPQ
捧腹	BDN ABP
捨棄	AOR EGW
掀起	IZC EHD
掃地	QKR GGS
掃帚	QKR XYB
掃描	QKR DII
授權	ZYC FGO
掌心	XPR Q1Q
掌握	XPR HED
掌故	XPR DLC
掌櫃	XPR FGQ
掌聲	XPR AUQ
掌舵	XPR GLR
排印	CQA HVW
排名	CQA DUE
排場	CQA LPQ
排外	CQA GOI
排水	CQA AGH
排洪	CQA JAA
排演	CQA LGR
排球	CQA FYM
排練	CQA IFS
排骨	CQA DAJ
採用	OTR LDC
採礦	OTR DRH
採納	OTR H2T
採訪	OTR BPO
採購	OTR DZC
採集	OTR P1T
探尋	F2Q R1Q
探測	F2Q TWT
探病	F2Q CSK
探知	F2Q JFQ
探究	F2Q DYO
探討	F2Q FKR
探訪	F2Q BPO
探險	F2Q I4Z
接力	N4T IWT
接受	N4T ZYB
接吻	N4T DXN
接壤	N4T CPR
接待	N4T GTR
接手	N4T AYB
接替	N4T FMS
接獲	N4T JTJ
接班	N4T ADA
接管	N4T DCH
接納	N4T H2T
接線	N4T QGS
接續	N4T RDD
接觸	N4T YDD
接踵	N4T XDB
接軌	N4T DGP
接送	N4T QAC
接連	N4T IGQ
掩護	H4Z JLC
描寫	DII QOR
描繪	DII JOI
描述	DII BVJ
插圖	T6T GLA
插座	T6T PLI
插手	T6T AYB
插曲	T6T EDP
插花	T6T ING
揚言	LPQ GZC
握手	HED AYB
揮動	IIS GAB
揮手	IIS AYB
揮發	IIS AZP
揮霍	IIS IQJ
損失	QAH AVT
損害	QAH JOS
損毀	QAH IFQ
損益	QAH HUX
搓揉	OLQ CYA
搖動	LIQ GAB
搖擺	LIQ APB
搖晃	LIQ JQH
搖籃	LIQ I3Q
搖頭	LIQ GZA
搗亂	EKR ICI
搗碎	EKR QSI
搭建	F3T DZE
搭配	F3T BSC
摒棄	AUG EGW
摧殘	PSG PCQ
摯友	XGS KYN
摯愛	XGS HTS
撕裂	QMQ IGT
撥款	ACD ECH
撫慰	BKN HIU
撲克	BAD EXT
撲救	BAD DYO
撲鼻	BAD CGG
擁戴	HDN ETS
擁抱	HDN CKB
擁有	HDN KYN
擁護	HDN JLC
擊退	DVT FSI
據悉	DJE QVT
據點	DJE E5R
擢升	LED AWQ
擬議	GHD GFA
擴充	JQI YBA
擴展	JQI JGR
擴建	JQI DZE
擺動	APB GAB
擺設	APB AGT
擾亂	CIR ICI
攀升	BDA AWQ
攀爬	BDA CNA
攀談	BDA G3Q
攜帶	JMG EOS
攜手	JMG AYB
攪拌	DJR BCA
支付	XFQ AKO
支持	XFQ LHQ
支架	XFQ DNS
支流	XFQ IYA
支線	XFQ QGS
支配	XFQ BSC
支隊	XFQ GSI
改動	DTR GAB
改善	DTR ZGR
改天	DTR FFQ
改嫁	DTR DNS
改寫	DTR QOR
改建	DTR DZE
改期	DTR FHC
改正	DTR XUS
改用	DTR LDC
改組	DTR NLB
改良	DTR IPQ
改變	DTR AGK
改進	DTR NVS
改道	DTR GKR
改革	DTR DTT
政務	XUS DKO
政客	XUS ERT
政局	XUS FDP
政府	XUS AKN
政改	XUS DTR
政權	XUS FGO
政界	XUS DQS
政策	XUS TTT
政績	XUS NVT
政黨	XUS EQR
故園	DLC KZS
故宮	DLC DBM
故意	DLC HHE
故此	DLC OFR
故鄉	DLC IPC
故里	DLC IHR
效力	JJS IWT
效應	JJS HWE
效果	JJS DLH
效法	JJS A9P
效用	JJS LDC
效益	JJS HUX
敏感	DVJ D2R
敏捷	DVJ P4T
救亡	DYO DPM
救命	DYO DSK
救國	DYO DXJ
救護	DYO JLC
救贖	DYO BDD
敘述	RJR BVJ
教友	DJS KYN
教堂	DJS GQQ
敬佩	DSA CSC
敬意	DSA HHE
敬業	DSA G8F
敬畏	DSA HIU
整個	XUR DLS
整天	XUR FFQ
整潔	XUR DFT
整理	XUR IHR
整頓	XUR EAI
整體	XUR FMR
敵人	GVT CVQ
敵對	GVT ESI
敵意	GVT HHE
敵軍	GVT DXS
敷設	BKM AGT
斃命	CNG DSK
文人	DXM CVQ
文件	DXM FGZ
文具	DXM FKU
文化	DXM INI
文員	DXM KXS
文字	DXM PHS
文學	DXM JED
文憑	DXM CWI
文明	DXM DSI
文書	DXM AJQ
文本	DXM AAB
文火	DXM ILH
文物	DXM DXP
文科	DXM ELG
文章	DXM XPQ
文筆	DXM AVL
文職	DXM XWT
文藝	DXM GNW
文體	DXM FMR
斐然	BIN CGQ
斑斕	ADA IEQ
斑紋	ADA DXM
斑馬	ADA DNB
斑駁	ADA AED
斑點	ADA E5R
斟酌	X1Q XPT
斥資	YUT NGQ
新人	QVQ CVQ
新型	QVQ JVQ
新娘	QVQ MPQ
新婚	QVQ IAG
新年	QVQ HFQ
新式	QVQ AWT
新潮	QVQ LIQ
新穎	QVQ LUH
旁人	CQA CVQ
旁證	CQA XWS
旁邊	CQA AFA
旅客	IJR ERT
旅社	IJR ZOR
旅程	IJR LUQ
旅舍	IJR AOR
旅遊	IJR LYA
旅館	IJR DCI
族人	PAD CVQ
族譜	PAD ALB
旗杆	FHC DCS
旗艦	FHC J7R
旗袍	FHC CKA
日光	CVT DQG
日前	CVT PFQ
日報	CVT AKC
日夜	CVT LOS
日子	CVT NHR
日常	CVT ZPQ
日期	CVT FHC
日照	CVT XIS
日益	CVT HUX
日記	CVT DHE
日趨	CVT OKG
日間	CVT DES
早安	NKR HCQ
早年	NKR HFQ
早日	NKR CVT
早晨	NKR BVQ
早期	NKR FHC
早熟	NKR ZBD
早餐	NKR OCQ
旭日	IDP CVT
昂貴	GQQ DIU
昌明	YPQ DSI
明亮	DSI IPS
明天	DSI FFQ
明媚	DSI DGK
明年	DSI HFQ
明文	DSI DXM
明日	DSI CVT
明星	DSI QVQ
明智	DSI JFS
明月	DSI GZV
明朗	DSI IQR
明滅	DSI DGH
明白	DSI CRD
明確	DSI EED
明證	DSI XWS
明顯	DSI IFR
昏暗	IAG H2S
昏睡	IAG ZFI
昔日	QUT CVT
星座	QVQ PLI
星星	QVQ QVQ
星期	QVQ FHC
星球	QVQ FYM
星辰	QVQ ZVQ
星際	QVQ NNS
映照	HSA XIS
映襯	HSA TWS
春天	YVG FFQ
春季	YVG DGM
春日	YVG CVT
春暉	YVG IIS
春秋	YVG OYA
春節	YVG NFT
春色	YVG VWT
昨夜	PQT LOS
昨天	PQT FFQ
昨晚	PQT DZN
是非	ZFR AIM
時代	ZHQ GTS
時刻	ZHQ EXT
時勢	ZHQ ANS
時報	ZHQ AKC
時宜	ZHQ GFY
時局	ZHQ FDP
時常	ZHQ ZPQ
時序	ZHQ RJR
時期	ZHQ FHC
時機	ZHQ DIC
時段	ZHQ GCI
時節	ZHQ NFT
時而	ZHQ CHQ
時辰	ZHQ ZVQ
時鐘	ZHQ XDA
時間	ZHQ DES
時限	ZHQ JER
時髦	ZHQ DKA
晃動	JQH GAB
晉級	NVS D1B
晚安	DZN HCQ
晚宴	DZN HFS
晚期	DZN FHC
晚輩	DZN ASC
晚間	DZN DES
晚霞	DZN JNQ
晚餐	DZN OCQ
晝夜	JYC LOS
晨曦	BVQ IFY
普及	BLB F1B
普照	BLB XIS
普羅	BLB ILQ
普通	BLB FAA
普遍	BLB AFC
景況	DSZ IPU
景物	DSZ DXP
景致	DSZ JGS
景色	DSZ VWT
景象	DSZ RPR
景點	DSZ E5R
晶片	NUQ BFC
晶體	NUQ FMR
智力	JFS IWT
智慧	JFS JMI
暑期	AJR FHC
暖意	HCH HHE
暖流	HCH IYA
暗喻	H2S LKI
暗室	H2S AVT
暗戀	H2S IGI
暗自	H2S PGS
暢快	KPS ERI
暢旺	KPS KPU
暢通	KPS FAA
暫停	P3S GVQ
暫時	P3S ZHQ
暫緩	P3S JCH
暮色	DLC VWT
曆法	IVT A9P
曇花	G2Q ING
曉得	IHR EXT
曙光	ZJS DQG
曲子	EDP NHR
曲尺	EDP YUT
曲目	EDP DBP
曲線	EDP QGS
曲藝	EDP GNW
書刊	AJQ ECQ
書包	AJQ AJA
書寫	AJQ QOR
書本	AJQ AAB
書桌	AJQ JED
書櫃	AJQ FGQ
書法	AJQ A9P
書生	AJQ VSQ
書目	AJQ DBP
書籍	AJQ PUT
書籤	AJQ O4Q
書記	AJQ DHE
書面	AJQ DGG
替代	FMS GTS
替身	FMS AVQ
最初	NOI TJQ
最終	NOI XBA
月亮	GZV IPS
月份	GZV AVI
月刊	GZV ECQ
月初	GZV TJQ
月季	GZV DGM
月曆	GZV IVT
月球	GZV FYM
月臺	GZV GTQ
月薪	GZV QVQ
月餅	GZV AUF
有利	KYN IGS
有力	KYN IWT
有名	KYN DUE
有害	KYN JOS
有意	KYN HHE
有效	KYN JJS
有時	KYN ZHQ
有機	KYN DIC
有理	KYN IHR
有益	KYN HUX
有關	KYN DDG
有限	KYN JER
有點	KYN E5R
朋友	CXA KYN
服侍	CBP ZHS
服刑	CBP JVQ
服務	CBP DKO
服用	CBP LDC
服飾	CBP AWT
朗誦	IQR RDC
期待	FHC GTR
期盼	FHC BEC
期許	FHC IJD
期貨	FHC ILI
期間	FHC DES
期限	FHC JER
木工	DAD DAA
木材	DAD PTQ
木板	DAD ADB
木瓜	DAD DNG
木筏	DAD CZP
木耳	DAD CHR
木頭	DAD GZA
未來	DIO ITQ
未嘗	DIO ZPQ
未婚	DIO IAG
未必	DIO AVH
末代	DCD GTS
末日	DCD CVT
末期	DCD FHC
末端	DCD ECG
本人	AAB CVQ
本來	AAB ITQ
本利	AAB IGS
本地	AAB GGS
本子	AAB NHR
本性	AAB QUS
本息	AAB QWT
本意	AAB HHE
本科	AAB ELG
本身	AAB AVQ
本金	AAB D1Y
本領	AAB IUR
本體	AAB FMR
李子	IHR NHR
杏仁	JRR CVQ
村子	OAG NHR
村民	OAG DVE
村莊	OAG SPQ
村落	OAG IQT
杜鵑	GLB DFG
東北	EAA AXD
東南	EAA H2Q
東西	EAA QMQ
松鼠	RDA AJR
板凳	ADB EXS
板塊	ADB ESI
板書	ADB AJQ
林地	I1Q GGS
林木	I1Q DAD
林業	I1Q G8F
林立	I1Q I1T
果仁	DLH CVQ
果園	DLH KZS
果子	DLH NHR
果實	DLH BVT
果汁	DLH X1T
果然	DLH CGQ
果皮	DLH CFI
果糖	DLH GQQ
果肉	DLH CBD
果醬	DLH NPS
枝節	XFQ NFT
架勢	DNS ANS
架子	DNS NHR
架構	DNS DZC
架次	DNS OGS
柏油	ARD LYA
柑橘	D3Q DVN
柔弱	CYA CPT
柔情	CYA PUQ
柔美	CYA DGJ
柔軟	CYA CGH
柔韌	CYA CVS
柔順	CYA BVI
核子	JTT NHR
核心	JTT Q1Q
核電	JTT GFS
根基	DBQ DHC
根底	DBQ EMR
根據	DBQ DJE
根本	DBQ AAB
根源	DBQ GZS
桂圓	DMI KGO
桂花	DMI ING
桃仁	GKQ CVQ
桃花	GKQ ING
框架	EPS DNS
案件	HCS FGZ
案例	HCS INS
案情	HCS PUQ
桌子	JED NHR
桔梗	DFT DRR
梅子	DSA NHR
條件	GHQ FGZ
條例	GHQ INS
條款	GHQ ECH
條碼	GHQ DNB
梯級	FMQ D1B
梳理	VJQ IHR
棄權	EGW FGO
棄置	EGW JHS
棉花	DGE ING
棉襖	DGE HKR
棒球	CEB FYM
棘手	DWF AYB
森林	V1Q I1Q
棲息	QMQ QWT
椰子	LOQ NHR
椰汁	LOQ X1T
楊柳	LPQ IYB
業主	G8F XKH
業務	G8F DKO
業界	G8F DQS
業績	G8F NVT
業餘	G8F LJQ
極力	FWF IWT
極品	FWF B1J
極地	FWF GGS
極端	FWF ECG
極點	FWF E5R
榛子	SWQ NHR
榮幸	KSO JTR
榮獲	KSO JTJ
榮耀	KSO LIS
榴槤/流連	IYA IGQ
構建	DZC DZE
構成	DZC ZUQ
構築	DZC JBD
樓市	IZA ZHR
樞機	YKG DIC
樞紐	YKG MYB
樟木	XPQ DAD
模仿	DLA BPN
模具	DLA FKU
模型	DLA JVQ
模式	DLA AWT
模擬	DLA GHD
模範	DLA C9N
模糊	DLA JLA
橄欖	D3R I3R
橋面	FIY DGG
機件	DIC FGZ
機制	DIC XNS
機動	DIC GAB
機器	DIC EGA
機場	DIC LPQ
機械	DIC JQS
機構	DIC DZC
機組	DIC NLB
機關	DIC DDG
機電	DIC GFS
機靈	DIC IVQ
機體	DIC FMR
橡皮	RPR CFI
檔案	EQQ HCS
檢察	D4Z TET
檢測	D4Z TWT
檢疫	D4Z LUJ
檢閱	D4Z LGJ
檢驗	D4Z G4A
檢點	D4Z E5R
檸檬	MRR DAA
櫃檯	FGQ GTQ
櫻桃	HTQ GKQ
權利	FGO IGS
權力	FGO IWT
權威	FGO HIS
權宜	FGO GFY
權益	FGO HUX
權術	FGO BVJ
權衡	FGO JRQ
權謀	FGO DYM
權貴	FGO DIU
次品	OGS B1J
次序	OGS RJR
次貨	OGS ILI
欣喜	IYC IHD
欣慰	IYC HIU
欣然	IYC CGQ
欣賞	IYC APR
欺壓	EHC H7T
欺詐	EHC SNS
款式	ECH AWT
款項	ECH JEB
歇息	IZF QWT
歌劇	DLQ FSB
歌唱	DLQ YPS
歌壇	DLQ GCQ
歌手	DLQ AYB
歌曲	DLQ EDP
歌聲	DLQ AUQ
歌舞	DLQ DKN
歌詞	DLQ RHQ
歌謠	DLQ LIQ
歌迷	DLQ DMA
歡喜	ICG IHD
歡心	ICG Q1Q
歡快	ICG ERI
歡愉	ICG LKG
歡欣	ICG IYC
止痛	XHR FAC
此刻	OFR EXT
此地	OFR GGS
此外	OFR GOI
步伐	CLC CZP
步驟	CLC UYC
武俠	DKN J5T
武力	DKN IWT
武功	DKN DAA
武器	DKN EGA
武士	DKN UHR
武藝	DKN GNW
武術	DKN BVJ
歲月	QNI GZV
歷代	IVT GTS
歷來	IVT ITQ
歷史	IVT VHR
歷屆	IVT DQS
歷時	IVT ZHQ
歷程	IVT LUQ
歷練	IVT IFS
歷險	IVT I4Z
歸化	DIS INI
歸屬	DIS ZDD
歸納	DIS H2T
死亡	QGR DPM
死人	QGR CVQ
死刑	QGR JVQ
死因	QGR HVU
死寂	QGR PVT
死者	QGR XOR
死鬼	QGR DIT
死黨	QGR EQR
殉職	RVI XWT
殊榮	ZKG KSO
殖民	ZWT DVE
殘局	PCQ FDP
殘廢	PCQ AUO
殘渣	PCQ SNQ
殘疾	PCQ PVT
殘破	PCQ BLC
殘酷	PCQ ECD
殘餘	PCQ LJQ
殯殮	AVG I4S
殲滅	N4Q DGH
段落	GCI IQT
毀滅	IFQ DGH
毅然	GIE CGQ
母體	DZB FMR
毒品	GCD B1J
毒物	GCD DXP
毒素	GCD QLC
毒藥	GCD LPT
毗連	CGE IGQ
毗鄰	CGE IVQ
毛利	DKA IGS
毛孔	DKA EAB
毛巾	DKA DVY
毛病	DKA CSK
毛皮	DKA CFI
毛筆	DKA AVL
毛髮	DKA AZP
毫克	JKQ EXT
毫升	JKQ AWQ
毫米	JKQ DMB
民主	DVE XKH
民俗	DVE RDD
民兵	DVE ASI
民國	DVE DXJ
民宅	DVE LRT
民心	DVE Q1Q
民政	DVE XUS
民族	DVE PAD
民歌	DVE DLQ
民營	DVE LUG
民生	DVE VSQ
民航	DVE JQQ
民謠	DVE LIQ
民間	DVE DES
水位	AGH KGQ
水利	AGH IGS
水坑	AGH ERQ
水域	AGH KWR
水塘	AGH GQQ
水壓	AGH H7T
水壺	AGH JLA
水庫	AGH ELC
水彩	AGH OTR
水患	AGH JDI
水手	AGH AYB
水文	AGH DXM
水晶	AGH NUQ
水果	AGH DLH
水池	AGH LFQ
水泡	AGH BJA
水流	AGH IYA
水渠	AGH FJC
水源	AGH GZS
水溫	AGH HAG
水漬	AGH PFS
水療	AGH IIS
水管	AGH DCH
水腫	AGH XDB
水花	AGH ING
水貨	AGH ILI
水路	AGH ILC
水道	AGH GKR
水鄉	AGH IPC
水銀	AGH GVY
水陸	AGH IBD
水面	AGH DGG
永久	KSP DYN
汁液	X1T LUT
求助	FYM UJS
求情	FYM PUQ
求愛	FYM HTS
求生	FYM VSQ
求知	FYM JFQ
求職	FYM XWT
求證	FYM XWS
江南	DEA H2Q
江山	DEA VEQ
江湖	DEA JLA
池塘	LFQ GQQ
沉寂	L1Q PVT
沉淪	L1Q IVG
沉澱	L1Q GFS
沉睡	L1Q ZFI
沉迷	L1Q DMA
沉醉	L1Q NGI
沉默	L1Q DXD
沐浴	DAD LDD
河水	JLQ AGH
河流	JLQ IYA
河馬	JLQ DNB
沸水	AIO AGH
沸騰	AIO GXQ
油煙	LYA HFQ
油門	LYA DAA
沿岸	LGG GCS
沿海	LGG ITR
沿用	LGG LDC
沿線	LGG QGS
沿路	LGG ILC
沿途	LGG GLA
泉水	PGG AGH
泉源	PGG GZS
法人	A9P CVQ
法典	A9P EFR
法制	A9P XNS
法則	A9P NXT
法力	A9P IWT
法學	A9P JED
法官	A9P DCG
法定	A9P GVS
法師	A9P VGQ
法庭	A9P GVQ
法律	A9P IVJ
法案	A9P HCS
法理	A9P IHR
法紀	A9P DHD
法規	A9P DFK
泡菜	BJA OTS
波動	ALA GAB
波及	ALA F1B
波濤	ALA GKQ
注意	XKI HHE
注資	XKI NGQ
泰斗	FOS EZB
洋溢	LPQ LVT
津貼	NVQ F5T
洪水	JAA AGH
洪流	JAA IYA
洽商	J6T APQ
派對	BPC ESI
派系	BPC JMS
派駐	BPC JKI
流亡	IYA DPM
流動	IYA GAB
流域	IYA KWR
流失	IYA AVT
流感	IYA D2R
流星	IYA QVQ
流暢	IYA KPS
流氓	IYA DTA
流水	IYA AGH
流派	IYA BPC
流淚	IYA IGI
流程	IYA LUQ
流落	IYA IQT
流血	IYA IFJ
流通	IYA FAA
流逝	IYA ZNS
流露	IYA ILC
流體	IYA FMR
浮動	CYM GAB
浮沉	CYM L1Q
浮游	CYM LYA
浮現	CYM JFS
浴缸	LDD JEA
海口	ITR EZB
海味	ITR DIO
海員	ITR KXS
海嘯	ITR QHS
海域	ITR KWR
海報	ITR AKC
海外	ITR GOI
海岸	ITR GCS
海峽	ITR J6T
海帶	ITR EOS
海水	ITR AGH
海洋	ITR LPQ
海港	ITR DEB
海潮	ITR LIQ
海灣	ITR HDG
海獅	ITR VGQ
海盜	ITR GKS
海綿	ITR DGE
海膽	ITR E3R
海藻	ITR NKR
海螺	ITR ILG
海豚	ITR GAG
海豹	ITR AJC
海軍	ITR DXS
海運	ITR KXU
海關	ITR DDG
海面	ITR DGG
海鳥	ITR EHR
海鷗	ITR HZA
浸泡	N1S BJA
浸透	N1S FZC
消化	QIQ INI
消失	QIQ AVT
消弭	QIQ DFF
消息	QIQ QWT
消暑	QIQ AJR
消極	QIQ FWF
消毒	QIQ GCD
消沉	QIQ L1Q
消滅	QIQ DGH
消瘦	QIQ VYC
消退	QIQ FSI
消逝	QIQ ZNS
消閒	QIQ DEQ
液晶	LUT NUQ
液體	LUT FMR
淋巴	I1Q ANA
淋浴	I1Q LDD
淋漓	I1Q IFQ
淒厲	OMQ INS
淒美	OMQ DGJ
淒迷	OMQ DMA
淚水	IGI AGH
淚珠	IGI XKG
淚眼	IGI GER
淨值	PUS LHS
淨化	PUS INI
淪落	IVG IQT
淪陷	IVG J6S
淫穢	L1Q HUU
淵博	HFG AQD
淵源	HFG GZS
混亂	JAH ICI
混戰	JAH XGS
混淆	JAH JJQ
混雜	JAH P2T
淺白	OGR CRD
淺色	OGR VWT
添加	F5Q DNQ
添置	F5Q JHS
清幽	OUQ H0U
清新	OUQ QVQ
清早	OUQ NKR
清明	OUQ DSI
清晨	OUQ BVQ
清楚	OUQ TJS
清潔	OUQ DFT
清澈	OUQ LGT
清爽	OUQ VPR
清理	OUQ IHR
清白	OUQ CRD
清盤	OUQ CCA
清算	OUQ QCH
清脆	OUQ ONI
清蒸	OUQ XWQ
清貧	OUQ CVI
清雅	OUQ GNR
清靜	OUQ PUR
清香	OUQ IPC
減壓	D6R H7T
減弱	D6R CPT
減肥	D6R CIM
渡輪	GLC IVG
渣滓	SNQ SHR
測繪	TWT JOI
測驗	TWT G4A
港人	DEB CVQ
港口	DEB EZB
港府	DEB AKN
游泳	LYA KSQ
渺茫	DIF DQA
湍急	FCG D1B
湍流	FCG IYA
湖泊	JLA CQD
湖畔	JLA CCC
源流	GZS IYA
源自	GZS PGS
源頭	GZS GZA
溜冰	IYC AWI
溝渠	DZA FJC
溝通	DZA FAA
溪流	EMQ IYA
溫婉	HAG HZT
溫室	HAG AVT
溫帶	HAG EOS
溫床	HAG UPQ
溫情	HAG PUQ
溫暖	HAG HCH
溫柔	HAG CYA
溫泉	HAG PGG
溫潤	HAG CVI
溫熱	HAG CGT
溫習	HAG R1T
溫飽	HAG AJB
溫馨	HAG IVQ
滅亡	DGH DPM
滅火	DGH ILH
滅絕	DGH PGJ
滋味	NHQ DIO
滋擾	NHQ CIR
滋潤	NHQ CVI
滋生	NHQ VSQ
滋補	NHQ ALB
滔滔	FKQ FKQ
滲入	V1S C1T
滴水	EVT AGH
滿天	DCB FFQ
滿座	DCB PLI
滿意	DCB HHE
滿目	DCB DBP
漁業	GJC G8F
漁船	GJC BGG
漆器	OVT EGA
漏水	IZC AGH
演化	LGR INI
演員	LGR KXS
演唱	LGR YPS
演奏	LGR NZC
演技	LGR FFZ
演練	LGR IFS
演繹	LGR LUT
演習	LGR R1T
演藝	LGR GNW
演講	LGR DEB
演變	LGR AGK
漠然	DQD CGQ
漢子	ICS NHR
漢字	ICS PHS
漣漪	IGQ HFY
漫天	DCC FFQ
漫步	DCC CLC
漫遊	DCC LYA
潔淨	DFT PUS
潔白	DFT CRD
潤澤	CVI LRT
潮水	LIQ AGH
潮汐	LIQ RUT
潮流	LIQ IYA
潰瘍	JSI LPQ
澱粉	GFS AXN
激情	DVT PUQ
激昂	DVT GQQ
激流	DVT IYA
激烈	DVT IGT
激發	DVT AZP
濃密	MDA DVL
濃烈	MDA IGT
濃縮	MDA VBD
濃郁	MDA HBP
濱海	AVE ITR
灌注	DCI XKI
火光	ILH DQG
火勢	ILH ANS
火化	ILH INI
火山	ILH VEQ
火星	ILH QVQ
火柴	ILH UPQ
火炭	ILH FCS
火炮	ILH BJC
火焰	ILH L4S
火熱	ILH CGT
火爐	ILH ILA
火箭	ILH NGS
火紅	ILH JAA
火腿	ILH FSH
火舌	ILH BGT
火花	ILH ING
火葬	ILH NQS
火藥	ILH LPT
火警	ILH DSZ
火速	ILH QAD
火鍋	ILH DLG
火雞	ILH DMQ
灰塵	ISG LVQ
灰燼	ISG PVS
灰色	ISG VWT
灼熱	XPT CGT
灼痛	XPT FAC
災民	NTQ DVE
災禍	NTQ JLH
炊具	YFG FKU
炎熱	K4Y CGT
炒家	TJR DNQ
炒菜	TJR OTS
炒麵	TJR DFC
炫耀	JFI LIS
炮兵	BJC ASI
烈士	IGT UHR
烈日	IGT CVT
烈焰	IGT L4S
烏黑	HLA IXT
烙印	IQT HVW
烽火	BDM ILH
焊接	ICR N4T
無力	DKM IWT
無助	DKM UJS
無常	DKM ZPQ
無形	DKM JVQ
無心	DKM Q1Q
無恙	DKM LPS
無情	DKM PUQ
無意	DKM HHE
無故	DKM DLC
無效	DKM JJS
無敵	DKM GVT
無暇	DKM JNS
無機	DKM DIC
無法	DKM A9P
無理	DKM IHR
無瑕	DKM JNQ
無異	DKM LHS
無疑	DKM GHC
無益	DKM HUX
無知	DKM JFQ
無禮	DKM IMR
無私	DKM QGQ
無窮	DKM FBM
無端	DKM ECG
無緣	DKM LGG
無聊	DKM IHQ
無聲	DKM AUQ
無言	DKM GZC
無誤	DKM GLC
無論	DKM IAG
無謂	DKM KIU
無賴	DKM IOS
無辜	DKM DLA
無間	DKM DES
無關	DKM DDG
無限	DKM JER
無際	DKM NNS
無須/無需	DKM QKG
無非	DKM AIM
焦急	NIQ D1B
焦慮	NIQ IJS
焦躁	NIQ NKS
焦點	NIQ E5R
然而	CGQ CHQ
煙火	HFQ ILH
煙花	HFQ ING
煤油	DSA LYA
煤炭	DSA FCS
煤礦	DSA DRH
煥發	ICI AZP
照例	XIS INS
照明	XIS DSI
照片	XIS BFC
照耀	XIS LIS
照顧	XIS DLC
煩亂	CZM ICI
煩悶	CZM DAC
煩惱	CZM HKR
煩瑣	CZM QLH
熄滅	QWT DGH
熄火	QWT ILH
熒幕	JVG DQD
熟客	ZBD ERT
熟悉	ZBD QVT
熟睡	ZBD ZFI
熟絡	ZBD IQT
熟練	ZBD IFS
熟習	ZBD R1T
熬藥	GKQ LPT
熱力	CGT IWT
熱帶	CGT EOS
熱心	CGT Q1Q
熱忱	CGT Z1Q
熱情	CGT PUQ
熱愛	CGT HTS
熱烈	CGT IGT
熱線	CGT QGS
熱血	CGT IFJ
熱誠	CGT ZUQ
熱身	CGT AVQ
熱門	CGT DAA
熱點	CGT E5R
熾烈	YHS IGT
熾熱	YHS CGT
燃點	CGQ E5R
燈光	EXQ DQG
燈塔	EXQ F3T
營地	LUG GGS
營建	LUG DZE
營救	LUG DYO
營業	LUG G8F
營辦	LUG CEC
營運	LUG KXU
燦爛	OCS ICS
爐子	ILA NHR
爐火	ILA ILH
爬山	CNA VEQ
爭執	STQ X1T
爭奪	STQ GCJ
爭持	STQ LHQ
爭議	STQ GFA
爭辯	STQ CGJ
爭鬥	STQ EZC
爵士	NPT UHR
爸爸	CLB CLB
爽朗	VPR IQR
牆壁	PPQ AVD
牆紙	PPQ XFR
牆角	PPQ DED
片刻	BFC EXT
片段	BFC GCI
片面	BFC DGG
版圖	ADB GLA
版本	ADB AAB
版權	ADB FGO
牙籤	GNQ O4Q
牙醫	GNQ HHC
牙關	GNQ DDG
牙齒	GNQ YHR
牛市	GYM ZHR
牛排	GYM CQA
牛肉	GYM CBD
謀利/牟利	DYM IGS
牡丹	DZB ECQ
牧師	DBP VGQ
牧童	DBP GAA
物件	DXP FGZ
物價	DXP DNS
物力	DXP IWT
物化	DXP INI
物品	DXP B1J
物業	DXP G8F
物流	DXP IYA
物理	DXP IHR
物色	DXP VWT
物證	DXP XWS
物資	DXP NGQ
物體	DXP FMR
牲口	VSQ EZB
特價	GXT DNS
特刊	GXT ECQ
特別	GXT CGL
特地	GXT GGS
特定	GXT GVS
特寫	GXT QOR
特性	GXT QUS
特惠	GXT JMI
特意	GXT HHE
特技	GXT FFZ
特權	GXT FGO
特殊	GXT ZKG
特派	GXT BPC
特色	GXT VWT
特許	GXT IJD
特輯	GXT P1T
特邀	GXT HIU
特點	GXT E5R
犀利	QMQ IGS
犧牲	IFY VSQ
犯案	C9N HCS
犯罪	C9N PSH
犯規	C9N DFK
狀元	UPS GZS
狀態	UPS FTS
狀況	UPS IPU
狐疑	JLA GHC
狙擊	OJQ DVT
狩獵	AYC I4T
狹小	J6T QIR
狹窄	J6T SRT
狹義	J6T GFA
狹隘	J6T HPS
猛力	DRB IWT
猛烈	DRB IGT
猛然	DRB CGQ
猜拳	OTQ FGO
猝死	OAJ QGR
猝然	OAJ CGQ
猴子	JZA NHR
獅子	VGQ NHR
獎勵	NPR INS
獎章	NPR XPQ
獎賞	NPR APR
獎金	NPR D1Y
獎項	NPR JEB
獨佔	GAD E5Q
獨到	GAD EKS
獨力	GAD IWT
獨奏	GAD NZC
獨有	GAD KYN
獨步	GAD CLC
獨特	GAD GXT
獨白	GAD CRD
獨立	GAD I1T
獨自	GAD PGS
獨資	GAD NGQ
獲准	JTJ XVH
獲利	JTJ IGS
獲得	JTJ EXT
獲悉	JTJ QVT
獲獎	JTJ NPR
獲知	JTJ JFQ
獵殺	I4T VET
獵物	I4T DXP
獸醫	AYC HHC
玄機	JFG DIC
玄關	JFG DDG
玉器	GDP EGA
玉米	GDP DMB
玩具	GCI FKU
玻璃	BLA IFQ
珊瑚	QCQ JLA
珍品	JVQ B1J
珍寶	JVQ AKB
珍惜	JVQ QUT
珍珠	JVQ XKG
珍稀	JVQ IIC
珍貴	JVQ DIU
珠寶	XKG AKB
班底	ADA EMR
班次	ADA OGS
班級	ADA D1B
現金/現今	JFS D1Y
現代	JFS GTS
現場	JFS LPQ
現存	JFS PAG
現實	JFS BVT
現時	JFS ZHQ
現狀	JFS UPS
現象	JFS RPR
現貨	JFS ILI
球員	FYM KXS
球場	FYM LPQ
球拍	FYM BRD
球賽	FYM QTS
球迷	FYM DMA
理念	IHR H5S
理性	IHR QUS
理想	IHR QPR
理智	IHR JFS
理由	IHR LYA
理科	IHR ELG
理財	IHR PTQ
琥珀	ILB BRD
琵琶	CGE CNA
瑕疵	JNQ PFQ
瑜伽	LKG FMC
瑟縮	VWT VBD
瑣碎	QLH QSI
璀璨	OSH OCS
環保	JDG AKB
環境	JDG DSZ
環抱	JDG CKB
環球	JDG FYM
環節	JDG NFT
環線	JDG QGS
環遊	JDG LYA
瓜子	DNG NHR
瓜果	DNG DLH
瓷器	PGQ EGA
瓷瓶	PGQ CVA
甘心	D3Q Q1Q
甘油	D3Q LYA
甘甜	D3Q G5Q
甘草	D3Q OKR
甘蔗	D3Q XOS
甘願	D3Q GZU
甜品	G5Q B1J
甜美	G5Q DGJ
甜蜜	G5Q DVH
甜酒	G5Q NYB
甜點	G5Q E5R
用具	LDC FKU
用力	LDC IWT
用功	LDC DAA
用品	LDC B1J
用字	LDC PHS
用心	LDC Q1Q
用膳	LDC ZGS
用途	LDC GLA
田園	GFQ KZS
田地	GFQ GGS
田徑	GFQ DVS
田螺	GFQ ILG
甲板	D7T ADB
申報	AVQ AKC
申訴	AVQ QLC
申辦	AVQ CEC
申辯	AVQ CGJ
申領	AVQ IUR
男人	H2Q CVQ
男士	H2Q UHR
男子	H2Q NHR
男性	H2Q QUS
男生	H2Q VSQ
界定	DQS GVS
界限	DQS JER
畏縮	HIU VBD
畢業	AVH G8F
畢生	AVH VSQ
畢竟	AVH DSA
異化	LHS INI
異味	LHS DIO
異國	LHS DXJ
異地	LHS GGS
異域	LHS KWR
異常	LHS ZPQ
異彩	LHS OTR
異性	LHS QUS
異物	LHS DXP
異端	LHS ECG
異議	LHS GFA
異鄉	LHS IPC
畸型/畸形	DFY JVQ
疑似	GHC RHR
疑問	GHC DXO
疑團	GHC GCG
疑惑	GHC JXJ
疑慮	GHC IJS
疑犯	GHC C9N
疑點	GHC E5R
疫情	LUJ PUQ
疫苗	LUJ DII
疲倦	CFI FGQ
疲弱	CFI CPT
疲憊	CFI CQC
疼愛	GCA HTS
疼痛	GCA FAC
疾病	PVT CSK
病人	CSK CVQ
病例	CSK INS
病因	CSK HVU
病患	CSK JDI
病情	CSK PUQ
病態	CSK FTS
病歷	CSK IVT
病毒	CSK GCD
病理	CSK IHR
病變	CSK AGK
病逝	CSK ZNS
痕跡	JBQ NUT
痙攣	FUV IGG
痛心	FAC Q1Q
痛快	FAC ERI
痛擊	FAC DVT
痛楚	FAC TJS
瘀血	HJE IFJ
瘡痍	TPQ LGQ
瘦削	VYC QPT
瘦弱	VYC CPT
瘦肉	VYC CBD
瘧疾	GPF PVT
療法	IIS A9P
療程	IIS LUQ
登場	EXQ LPQ
登山	EXQ VEQ
登記	EXQ DHE
發亮	AZP IPS
發佈	AZP ALC
發信	AZP QVS
發動	AZP GAB
發售	AZP ZYC
發問	AZP DXO
發奮	AZP AXO
發展	AZP JGR
發憤	AZP CXN
發抖	AZP EZB
發揚	AZP LPQ
發揮	AZP IIS
發明	AZP DSI
發源	AZP GZS
發熱	AZP CGT
發現	AZP JFS
發球	AZP FYM
發生	AZP VSQ
發病	AZP CSK
發育	AZP LBD
發芽	AZP GNQ
發表	AZP AIJ
發言	AZP GZC
發誓	AZP ZNS
發起	AZP EHD
發送	AZP QAC
發酵	AZP DJS
發電	AZP GFS
發音	AZP H1Y
白天	CRD FFQ
白字	CRD PHS
白描	CRD DII
白果	CRD DLH
白瓷	CRD PGQ
白色	CRD VWT
白薯	CRD ZJS
白話	CRD JRI
白酒	CRD NYB
白領	CRD IUR
白頭	CRD GZA
白髮	CRD AZP
百姓	ARD QUS
百年	ARD HFQ
百貨	ARD ILI
的士	EVT UHR
的確	EVT EED
皇室	JQG AVT
皇家	JQG DNQ
皇帝	JQG EMS
皮層	CFI PXQ
皮球	CFI FYM
皮箱	CFI QPQ
皮膚	CFI AKM
皺眉	SYC DGI
盆地	CAA GGS
盆子	CAA NHR
盈利/贏利	LUQ IGS
盈餘	LUQ LJQ
益智	HUX JFS
盜版	GKS ADB
盜用	GKS LDC
盜竊	GKS OFT
盜賊	GKS PXT
盤問	CCA DXO
盤算	CCA QCH
盤踞	CCA DJE
目光	DBP DQG
目前	DBP PFQ
目擊	DBP DVT
目的	DBP EVT
目送	DBP QAC
盲目	DRA DBP
盲點	DRA E5R
直徑	LWT DVS
直接	LWT N4T
直立	LWT I1T
直線	LWT QGS
直至	LWT XGS
直通	LWT FAA
直面	LWT DGG
眉宇	DGI KKT
眉梢	DGI VJQ
眉目	DGI DBP
眉頭	DGI GZA
眨眼	S6T GER
眷戀	DGQ IGI
眷顧	DGQ DLC
眼前	GER PFQ
眼底	GER EMR
眼淚	GER IGI
眼球	GER FYM
眼界	GER DQS
眼皮	GER CFI
眼眶	GER EPS
眼瞼	GER D4Z
眼神	GER BVQ
眼簾	GER I4Q
眼罩	GER JJS
眼鏡	GER DSA
睡眠	ZFI DFA
睡袋	ZFI GTS
督察	ECD TET
督導	ECD GKS
睫毛	N4T DKA
睿智	LNI JFS
瞎子	IDT NHR
瞬間	AVI DES
瞳孔	GAA EAB
矚目	XDD DBP
矛頭	DYM GZA
知名	JFQ DUE
知己	JFQ DHD
知心	JFQ Q1Q
知悉	JFQ QVT
知情	JFQ PUQ
知道	JFQ GKR
知音	JFQ H1Y
短訊/短信	ECH QVS
短暫	ECH P3S
短期	ECH FHC
短片	ECH BFC
短線	ECH QGS
短跑	ECH BJB
矮小	HPR QIR
矯健	DIZ FZE
石像	ZUT RPR
石刻	ZUT EXT
石板	ZUT ADB
石棉	ZUT DGE
石榴	ZUT IYA
石油	ZUT LYA
石灰	ZUT ISG
石碑	ZUT AFI
石窟	ZUT EAJ
石階	ZUT DQQ
石雕	ZUT EHQ
石頭	ZUT GZA
砂糖	VNQ GQQ
研發	GFS AZP
研究	GFS DYO
研習	GFS R1T
研製	GFS XNS
研討	GFS FKR
研讀	GFS GAD
砧板	J1Q ADB
破例	BLC INS
破損	BLC QAH
破曉	BLC IHR
破案	BLC HCS
破滅	BLC DGH
破綻	BLC LES
破裂	BLC IGT
破門	BLC DAA
硬幣	GTS CNG
硬性	GTS QUS
硬朗	GTS IQR
碎片	QSI BFC
碎石	QSI ZUT
碑文	AFI DXM
碑林	AFI I1Q
碑記	AFI DHE
碧藍	ASL I3Q
碩士	ZUT UHR
確保	EED AKB
確定	EED GVS
確實	EED BVT
確立	EED I1T
碼頭	DNB GZA
磊落	ISH IQT
礦場	DRH LPQ
礦工	DRH DAA
礦物	DRH DXP
社交	ZOR DJQ
社團	ZOR GCG
祈求	FIC FYM
祈福	FIC ABP
祖國	NLB DXJ
祖宗	NLB NCA
祖母	NLB DZB
祖籍	NLB PUT
神似	BVQ RHR
神位	BVQ KGQ
神像	BVQ RPR
神學	BVQ JED
神州	BVQ XYA
神廟	BVQ DIK
神情	BVQ PUQ
神態	BVQ FTS
神明	BVQ DSI
神智	BVQ JFS
神童	BVQ GAA
神聖	BVQ AUS
神色	BVQ VWT
神話	BVQ JRI
神靈	BVQ IVQ
神韻	BVQ KXU
神龕	BVQ E2Q
祠堂	RHQ GQQ
禍根	JLH DBQ
福利	ABP IGS
福祉	ABP KHR
禮儀	IMR GFY
禮制	IMR XNS
禮器	IMR EGA
禮堂	IMR GQQ
禮服	IMR CBP
禮物	IMR DXP
禮讓	IMR CPS
禮貌	IMR DJC
禮遇	IMR GKU
禽鳥	F1Y EHR
秀美	QYC DGJ
私人	QGQ CVQ
私家	QGQ DNQ
私有	QGQ KYN
私營	QGQ LUG
私立	QGQ I1T
秉承	ASJ ZWQ
秉持	ASJ LHQ
秋天	OYA FFQ
秋季	OYA DGM
科幻	ELG JEI
科目	ELG DBP
租用	NLA LDC
租界	NLA DQS
租賃	NLA M1S
租金	NLA D1Y
秩序	LVT RJR
移交	LFQ DJQ
移動	LFQ GAB
移師	LFQ VGQ
移民	LFQ DVE
稀有	IIC KYN
稀薄	IIC CQD
稀釋	IIC AUT
稅制	ANI XNS
稅務	ANI DKO
稅款	ANI ECH
稅法	ANI A9P
程式	LUQ AWT
稍微	VJS DIM
稍稍	VJS VJS
稟報	A1J AKC
稟賦	A1J AKO
稠密	LYA DVL
稻穀	GKR DAD
稻米	GKR DMB
穀物	DAD DXP
穩健	HAH FZE
穩固	HAH DLC
穩妥	HAH FLH
穩定	HAH GVS
穩步	HAH CLC
究竟	DYO DSA
空中	EAA JBA
空位	EAC KGQ
空地	EAC GGS
空地	EAA GGS
空姐	EAA NOR
空曠	EAA EQI
空白	EAC CRD
空軍	EAA DXS
空運	EAA KXU
突擊	GAJ DVT
突然	GAJ CGQ
突發	GAJ AZP
突破	GAJ BLC
突襲	GAJ R1T
突變	GAJ AGK
突起	GAJ EHD
窒息	JVT QWT
窮人	FBM CVQ
窮困	FBM EAI
窺探	EFK F2Q
竅門	EHS DAA
立交	I1T DJQ
立刻	I1T EXT
立即	I1T NWT
立場	I1T LPQ
立志	I1T XHS
立時	I1T ZHQ
立法	I1T A9P
立體	I1T FMR
站立	J6S I1T
竟然	DSA CGQ
章程	XPQ LUQ
章節	XPQ NFT
竣工	OVG DAA
童心	GAA Q1Q
童裝	GAA SPQ
童話	GAA JRI
童軍	GAA DXS
端倪	ECG GMQ
端莊	ECG SPQ
競技	FSA FFZ
競爭	FSA STQ
競賽	FSA QTS
競逐	FSA LBD
筆名	AVL DUE
筆墨	AVL DXD
筆法	AVL A9P
筆者	AVL XOR
筆觸	AVL YDD
筆記	AVL DHE
等價	EXR DNS
等到	EXR EKS
等同	EXR GAA
等級	EXR D1B
筋骨	DYC DAJ
答案	E2T HCS
答謝	E2T ROS
答辯	E2T CGJ
策動	TTT GAB
策略	TTT IPT
筵席	LGQ RUT
管制	DCH XNS
管束	DCH ADD
管理	DCH IHR
管轄	DCH JDT
管道	DCH GKR
箭頭	NGS GZA
箱子	QPQ NHR
節儉	NFT F4Z
節制	NFT XNS
節奏	NFT NZC
節拍	NFT BRD
節日	NFT CVT
節流	NFT IYA
節目	NFT DBP
範例	C9N INS
範本	C9N AAB
範疇	C9N LYA
篇章	BGE XPQ
篡位	TDI KGQ
篤信	ECD QVS
篤定	ECD GVS
簇擁	OAD HDN
簇新	OAD QVQ
簡介	DER DQS
簡化	DER INI
簡報	DER AKC
簡歷	DER IVT
簡潔	DER DFT
簡略	DER IPT
簡直	DER LWT
簡訊	DER QVS
簡述	DER BVJ
籃板	I3Q ADB
籃球	I3Q FYM
籌備	LYA CGK
籌劃	LYA JTJ
籌募	LYA DLC
籌措	LYA OLC
籌款	LYA ECH
籌碼	LYA DNB
籌資	LYA NGQ
籌辦	LYA CEC
籌集	LYA P1T
米糠	DMB EQQ
米線	DMB QGS
粉末	AXN DCD
粉碎	AXN QSI
粉筆	AXN AVL
粉紅	AXN JAA
粉絲	AXN QHQ
粉飾	AXN AWT
粒子	I1T NHR
粗俗	PLB RDD
粗壯	PLB SPS
粗略	PLB IPT
粗糙	PLB OKS
粗話	PLB JRI
粗豪	PLB JKQ
粗鄙	PLB AGJ
精力	NUQ IWT
精妙	NUQ DIG
精子	NUQ NHR
精密	NUQ DVL
精彩	NUQ OTR
精心	NUQ Q1Q
精確	NUQ EED
精神	NUQ BVQ
精粹	NUQ QGI
精英	NUQ HSY
精裝	NUQ SPQ
精闢	NUQ CUH
精髓	NUQ QFH
糊口	JLA EZB
糊塗	JLA GLA
糖果	GQQ DLH
糙米	OKS DMB
糧草	IPQ OKR
系統	JMS FCC
糾察	D0V TET
糾紛	D0V BXM
紀律	DHD IVJ
紀念	DHD H5S
紅利	JAA IGS
紅包	JAA AJA
紅塵	JAA LVQ
紅旗	JAA FHC
紅潤	JAA CVI
紅潮	JAA LIQ
紅火	JAA ILH
紅燈	JAA EXQ
紅腫	JAA XDB
紅色	JAA VWT
紅豆	JAA GZC
紅軍	JAA DXS
紊亂	DXO ICI
紋理	DXM IHR
紋飾	DXM AWT
納入	H2T C1T
納稅	H2T ANI
納粹	H2T QGI
紙巾	XFR DVY
紙幣	XFR CNG
紙條	XFR GHQ
紙箱	XFR QPQ
級別	D1B CGL
紛亂	BXM ICI
紛爭	BXM STQ
紛紜	BXM KXS
紛飛	BXM AIM
素來	QLC ITQ
素材	QLC PTQ
素菜	QLC OTS
紫菜	NFR OTS
細則	QMS NXT
細嫩	QMS HAI
細密	QMS DVL
細小	QMS QIR
細微	QMS DIM
細心	QMS Q1Q
細碎	QMS QSI
細節	QMS NFT
細緻	QMS LGS
細膩	QMS MGS
終年	XBA HFQ
終日	XBA CVT
終極	XBA FWF
終止	XBA XHR
終究	XBA DYO
終端	XBA ECG
終結	XBA DFT
終身	XBA AVQ
組建	NLB DZE
組成	NLB ZUQ
結婚	DFT IAG
結存	DFT PAG
結實	DFT BVT
結局	DFT FDP
結拜	DFT AQC
結晶	DFT NUQ
結束	DFT ADD
結果	DFT DLH
結核	DFT JTT
結案	DFT HCS
結業	DFT G8F
結構	DFT DZC
結算	DFT QCH
結餘	DFT LJQ
絕倫	PGJ IVG
絕對	PGJ ESI
絕情	PGJ PUQ
絕技	PGJ FFZ
絕招	PGJ XIQ
絕色	PGJ VWT
絕跡	PGJ NUT
絡繹	IQT LUT
絢爛	IFI ICS
統一	FCC HVX
統籌	FCC LYA
統計	FCC DMS
統領	FCC IUR
絲毫	QHQ JKQ
絲瓜	QHQ DNG
綜藝	NCC GNW
綠化	IDD INI
綠洲	IDD XYA
綠燈	IDD EXQ
綠豆	IDD GZC
維修	LGG QYA
維持	LGG LHQ
維新	LGG QVQ
維護	LGG JLC
綱領	DQQ IUR
網友	DPN KYN
網址	DPN XHR
網球	DPN FYM
網站	DPN J6S
網羅	DPN ILQ
網路	DPN ILC
網點	DPN E5R
緊密	DVV DVL
緊急	DVV D1B
緊湊	DVV OZC
緘默	D6Q DXD
線上	QGS ZPS
線條	QGS GHQ
線路	QGS ILC
緣故	LGG DLC
緩刑	JCH JVQ
緩急	JCH D1B
緩慢	JCH DDC
緩步	JCH CLC
緩衝	JCH YDA
緬懷	DGF JQG
練功	IFS DAA
練習	IFS R1T
縮小	VBD QIR
縮影	VBD HSZ
縮減	VBD D6R
縮短	VBD ECH
縱使	NDC VHR
縱向	NDA IPE
縱情	NDC PUQ
績效	NVT JJS
繩子	BWQ NHR
繪製	JOI XNS
繼承	DMS ZWQ
繼續	DMS RDD
繼而	DMS CHQ
繽紛	BVE BXM
纖瘦	Q4Q VYC
纖細	Q4Q QMS
纖維	Q4Q LGG
罪人	PSH CVQ
罪名	PSH DUE
罪案	PSH HCS
罪犯	PSH C9N
罪行	PSH JRS
置身	JHS AVQ
罰款	CZP ECH
罹患	IFQ JDI
羊毛	LPQ DKA
美人	DGJ CVQ
美元	DGJ GZS
美化	DGJ INI
美味	DGJ DIO
美妙	DGJ DIG
美學	DGJ JED
美容	DGJ LDA
美感	DGJ D2R
美景	DGJ DSZ
美術	DGJ BVJ
美貌	DGJ DJC
美酒	DGJ NYB
羚羊	IVQ LPQ
羞怯	QYA E8F
羞澀	QYA V1T
羞辱	QYA CDD
義務	GFA DKO
義賣	GFA DPC
翅膀	AFS CQA
翌年	LWT HFQ
翌日	LWT CVT
習俗	R1T RDD
習字	R1T PHS
習性	R1T QUS
習慣	R1T DDI
翡翠	CIO OGI
翻修	BZM QYA
翻新	BZM QVQ
翻版	BZM ADB
翻譯	BZM LUT
翻身	BZM AVQ
翻閱	BZM LGJ
老人	IKR CVQ
老婆	IKR CLA
老子	IKR NHR
老實	IKR BVT
老師	IKR VGQ
老年	IKR HFQ
老式	IKR AWT
老成	IKR ZUQ
老虎	IKR ILB
老鼠	IKR AJR
考勤	EKR FYC
考古	EKR DLB
考場	EKR LPQ
考察	EKR TET
考慮	EKR IJS
考據	EKR DJE
考生	EKR VSQ
考究	EKR DYO
考績	EKR NVT
考試	EKR AHS
考證	EKR XWS
考驗	EKR G4A
耐久	HTS DYN
耐心	HTS Q1Q
耐性	HTS QUS
耐熱	HTS CGT
耕地	DTQ GGS
耕耘	DTQ KXS
耳朵	CHR ELH
耳機	CHR DIC
耳環	CHR JDG
耳目	CHR DBP
耶穌	LOQ QLA
聆訊	IVQ QVS
聖人	AUS CVQ
聖地	AUS GGS
聖母	AUS DZB
聖潔	AUS DFT
聖詩	AUS AHQ
聖誕	AUS GCR
聘書	BUG AJQ
聘用	BUG LDC
聲名	AUQ DUE
聲帶	AUQ EOS
聲明	AUQ DSI
聲言	AUQ GZC
聲音	AUQ H1Y
聲響	AUQ IPD
聳立	QDB I1T
職位	XWT KGQ
職務	XWT DKO
職員	XWT KXS
職場	XWT LPQ
職工	XWT DAA
職業	XWT G8F
職權	XWT FGO
職級	XWT D1B
職責	XWT STT
肄業	LGS G8F
肅穆	QBD DBP
肆意	QGS HHE
肆虐	QGS GPF
肉眼	CBD GER
肉體	CBD FMR
肉麻	CBD DNA
肋骨	IXT DAJ
肌肉	DGY CBD
肌膚	DGY AKM
肝炎	DCQ K4Y
股份	DLB AVI
股市	DLB ZHR
股息	DLB QWT
股本	DLB AAB
股東	DLB EAA
股權	DLB FGO
股民	DLB DVE
肢體	XFQ FMR
肥肉	CIM CBD
肩膀	DFQ CQA
肩負	DFQ CYN
肯定	EXR GVS
肺炎	BUO K4Y
胃口	KIU EZB
胃液	KIU LUT
胃炎	KIU K4Y
胡桃	JLA GKQ
胡椒	JLA NIQ
胡琴	JLA F1Y
胭脂	HFQ XGQ
胳膊	DQT BQD
胴體	GAC FMR
脖子	CAD NHR
腐乳	CKN CKH
腐朽	CKN IYN
腐蝕	CKN BWT
腦子	HKR NHR
腦海	HKR ITR
腦筋	HKR DYC
腦袋	HKR GTS
腫瘤	XDB IYC
腫脹	XDB JPS
腰斬	HIU S6R
腰果	HIU DLH
腰椎	HIU LGG
腳印	DPF HVW
腳尖	DPF N4Q
腳掌	DPF XPR
腳板	DPF ADB
腳步	DPF CLC
腳趾	DPF XHR
腳跟	DPF DBQ
腳踝	DPF JNH
膚淺	AKM OGR
膚色	AKM VWT
膽子	E3R NHR
膽識	E3R AWT
臍帶	PMQ EOS
臘腸	I3T LPQ
臥室	GLI AVT
臥底	GLI EMR
自主	PGS XKH
自信	PGS QVS
自修	PGS QYA
自備	PGS CGK
自制	PGS XNS
自助	PGS UJS
自動	PGS GAB
自卑	PGS AFE
自問	PGS DXO
自嘲	PGS JJQ
自家	PGS DNQ
自尊	PGS NAG
自己	PGS DHD
自強	PGS FPC
自律	PGS IVJ
自得	PGS EXT
自我	PGS GLR
自殘	PGS PCQ
自殺	PGS VET
自然	PGS CGQ
自由	PGS LYA
自發	PGS AZP
自私	PGS QGQ
自立	PGS I1T
自給	PGS D1B
自薦	PGS NFS
自豪	PGS JKQ
自負	PGS CYN
自身	PGS AVQ
自願	PGS GZU
至今	XGS D1Y
至尊	XGS NAG
至此	XGS OFR
致力	JGS IWT
致命	JGS DSK
致富	JGS AYO
致意	JGS HHE
致敬	JGS DSA
致謝	JGS ROS
致辭	JGS RHQ
致電	JGS GFS
舅媽	FYN DLB
舅舅	FYN FYN
舉例	DJD INS
舉動	DJD GAB
舉報	DJD AKC
舉家	DJD DNQ
舉手	DJD AYB
舉措	DJD OLC
舉止	DJD XHR
舉證	DJD XWS
舉辦	DJD CEC
舊日	FYO CVT
舊時	FYO ZHQ
舌頭	BGT GZA
舒服	AJQ CBP
舒緩	AJQ JCH
舞劇	DKN FSB
舞動	DKN GAB
舞姿	DKN NGQ
舞曲	DKN EDP
舞步	DKN CLC
舞臺	DKN GTQ
舞蹈	DKN GKS
航次	JQQ OGS
航海	JQQ ITR
航班	JQQ ADA
航程	JQQ LUQ
航空	JQQ EAA
航線	JQQ QGS
航運	JQQ KXU
航道	JQQ GKR
船員	BGG KXS
船塢	BGG HLB
船舶	BGG CRD
船隻	BGG XUT
艦隊	J7R GSI
良心	IPQ Q1Q
良性	IPQ QUS
良機	IPQ DIC
良知	IPQ JFQ
艱巨	DEQ FJD
艱辛	DEQ QVQ
色彩	VWT OTR
色情	VWT PUQ
色澤	VWT LRT
色盲	VWT DRA
色素	VWT QLC
芙蓉	CKM LDA
芝麻	XHQ DNA
芬芳	BXM BPM
芭蕉	ANA NIQ
芭蕾	ANA ISH
花叢	ING PAA
花園	ING KZS
花布	ING ALC
花旦	ING ECS
花朵	ING ELH
花椒	ING NIQ
花燈	ING EXQ
花瓣	ING CEC
花瓶	ING CVA
花生	ING VSQ
花白	ING CRD
花盆	ING CAA
花粉	ING AXN
花紅	ING JAA
花紋	ING DXM
花色	ING VWT
花茶	ING LNQ
花草	ING OKR
花蕾	ING ISH
花蜜	ING DVH
芳香	BPM IPC
芹菜	FYC OTS
苗條	DII GHQ
苛刻	JLQ EXT
英勇	HSY LDB
英尺	HSY YUT
英鎊	HSY BQA
英雄	HSY KBM
茫然	DQA CGQ
茴香	JSG IPC
茶具	LNQ FKU
茶壺	LNQ JLA
茶杯	LNQ ASA
茶樓	LNQ IZA
茶莊	LNQ SPQ
茶藝	LNQ GNW
茶道	LNQ GKR
茶點	LNQ E5R
草原	OKR GZS
草圖	OKR GLA
草地	OKR GGS
草坪	OKR CSI
草場	OKR LPQ
草擬	OKR GHD
草書	OKR AJQ
草木	OKR DAD
草根	OKR DBQ
草案	OKR HCS
草皮	OKR CFI
草藥	OKR LPT
荒漠	IQG DQD
荒蕪	IQG DKM
莊嚴	SPQ G8C
莊園	SPQ KZS
莊家	SPQ DNQ
莊稼	SPQ DNS
莫名	DQD DUE
莫非	DQD AIM
菊花	DBP ING
菜刀	OTS EKQ
菜譜	OTS ALB
菜館	OTS DCI
萌生	DTA VSQ
萌發	DTA AZP
萌芽	DTA GNQ
萬一	DZO HVX
萬全	DZO PGG
萬年	DZO HFQ
萬物	DZO DXP
落地	IQT GGS
落寞	IQT DQD
落實	IQT BVT
落成	IQT ZUQ
落淚	IQT IGI
落空	IQT EAA
落筆	IQT AVL
落腳	IQT DPF
落馬	IQT DNB
蒙受	DAA ZYB
蒙羞	DAA QYA
蒙蔽	DAA ANG
蒸發	XWQ AZP
蓬勃	CAA CAD
蓮子	IFQ NHR
蓮花	IFQ ING
蔗糖	XOS GQQ
蔬果	VJQ DLH
蔬菜	VJQ OTS
薄弱	CQD CPT
薄片	CQD BFC
薄霧	CQD DKO
薄餅	CQD AUF
薈萃	HOI PGI
薪水	QVQ AGH
薪酬	QVQ ZYA
薪金	QVQ D1Y
薯條	ZJS GHQ
薯片	ZJS BFC
藍圖	I3Q GLA
藍本	I3Q AAB
藝人	GNW CVQ
藝術	GNW BVJ
藥丸	LPT JCG
藥品	LPT B1J
藥物	LPT DXP
藥用	LPT LDC
藥膳	LPT ZGS
藥草	LPT OKR
蘊含	HXS J2Q
蘋果	CVE DLH
蘿蔔	ILQ CXD
虐待	GPF GTR
虔誠	FGY ZUQ
虧損	EFO QAH
虧本	EFO AAB
虧欠	EFO E8E
蚊子	DXM NHR
蚯蚓	EYM LVR
蛀牙	XKI GNQ
蜜月	DVH GZV
蜜桃	DVH GKQ
蜜棗	DVH NKR
蜜蜂	DVH BDM
蜥蜴	QVT LUT
蝙蝠	AFA ABP
蝦仁	JNQ CVQ
蝦米	JNQ DMB
融入	LBA C1T
融資	LBA NGQ
螺絲	ILG QHQ
蟹黃	JPR JQG
蠟燭	I3T XDD
蠱惑	DLB JXJ
血液	IFJ LUT
血漿	IFJ NPQ
血管	IFJ DCH
血糖	IFJ GQQ
血統	IFJ FCC
血緣	IFJ LGG
血脂	IFJ XGQ
衝動	YDA GAB
衝擊	YDA DVT
衝破	YDA BLC
衝突	YDA GAJ
表兄	AIJ ISO
表妹	AIJ DSC
表姐	AIJ NOR
表層	AIJ PXQ
表彰	AIJ XPQ
表情	AIJ PUQ
表態	AIJ FTS
表揚	AIJ LPQ
表明	AIJ DSI
表演	AIJ LGR
表現	AIJ JFS
表白	AIJ CRD
表皮	AIJ CFI
表述	AIJ BVJ
表露	AIJ ILC
表面	AIJ DGG
袋鼠	GTS AJR
袖口	RYC EZB
裂痕	IGT JBQ
補充	ALB YBA
補助	ALB UJS
補品	ALB B1J
補給	ALB D1B
補習	ALB R1T
補貼	ALB F5T
裝扮	SPQ AEC
裝置	SPQ JHS
裝設	SPQ AGT
裝運	SPQ KXU
裝飾	SPQ AWT
製備	XNS CGK
製品	XNS B1J
褻瀆	QGT GAD
襯衫	TWS V7Q
襲擊	R1T DVT
西北	QMQ AXD
西南	QMQ H2Q
西瓜	QMQ DNG
規例	DFK INS
規則	DFK NXT
規劃	DFK JTJ
規定	DFK GVS
規律	DFK IVJ
規模	DFK DLA
規矩	DFK DKT
規章	DFK XPQ
規範	DFK C9N
覬覦	DGA LKG
角力	DED IWT
角色	DED VWT
角落	DED IQT
角逐	DED LBD
觸動	YDD GAB
觸及	YDD F1B
觸犯	YDD C9N
觸發	YDD AZP
觸電	YDD GFS
言辭	GZC RHQ
訂立	EVS I1T
訂貨	EVS ILI
訂購	EVS DZC
訂金	EVS D1Y
計算	DMS QCH
訊問	QVS DXO
訓練	IXU IFS
記得	DHE EXT
記憶	DHE HWF
記敘	DHE RJR
記者	DHE XOR
記述	DHE BVJ
訝異	GNS LHS
訣別	DFJ CGL
訪問	BPO DXO
訪客	BPO ERT
設備	AGT CGK
設定	AGT GVS
設想	AGT QPR
設法	AGT A9P
設立	AGT I1T
設置	AGT JHS
設計	AGT DMS
許久	IJD DYN
許可	IJD ELR
許多	IJD ELQ
許諾	IJD HQT
許願	IJD GZU
詞人	RHQ CVQ
詞典	RHQ EFR
詞義	RHQ GFA
詢問	QVG DXO
試圖	AHS GLA
試探	AHS F2Q
試用	AHS LDC
試驗	AHS G4A
試點	AHS E5R
詩人	AHQ CVQ
詩壇	AHQ GCQ
詩意	AHQ HHE
詩文	AHQ DXM
詩歌	AHQ DLQ
詩篇	AHQ BGE
詩詞	AHQ RHQ
詩集	AHQ P1T
詩體	AHQ FMR
詭異	DFP LHS
詮釋	OGG AUT
話劇	JRI FSB
話音	JRI H1Y
該死	DTQ QGR
詼諧	ESG JQQ
誇耀	ENG LIS
誓詞	ZNS RHQ
誘因	LYB HVU
誘導	LYB GKS
誘發	LYB AZP
誠信	ZUQ QVS
誠實	ZUQ BVT
誠意	ZUQ HHE
誠懇	ZUQ EBR
誠然	ZUQ CGQ
誤導	GLC GKS
誦讀	RDC GAD
課堂	ELI GQQ
課本	ELI AAB
課程	ELI LUQ
課餘	ELI LJQ
談判	G3Q BCC
談話	G3Q JRI
諍友	STS KYN
諧謔	JQQ IPF
諧音	JQQ H1Y
諷喻	ABO LKI
諾言	HQT GZC
謀殺	DYM VET
謀生	DYM VSQ
謀略	DYM IPT
謎底	DMC EMR
謙卑	E5Q AFE
講師	DEB VGQ
講座	DEB PLI
講授	DEB ZYC
講求	DEB FYM
講究	DEB DYO
講話	DEB JRI
講述	DEB BVJ
謝幕	ROS DQD
謝意	ROS HHE
謝謝	ROS ROS
謹記	DYD DHE
證人	XWS CVQ
證件	XWS FGZ
證實	XWS BVT
證據	XWS DJE
證明	XWS DSI
證書	XWS AJQ
證物	XWS DXP
譜寫	ALB QOR
警報	DSZ AKC
警察	DSZ TET
警惕	DSZ FVT
警署	DSZ ZJS
警訊	DSZ QVS
警鐘	DSZ XDA
譬喻	BFG LKI
譯本	LUT AAB
議價	GFA DNS
議員	GFA KXS
議席	GFA RUT
議案	GFA HCS
譴責	EGW STT
護士	JLC UHR
護理	JLC IHR
護膚	JLC AKM
護送	JLC QAC
讀書	GAD AJQ
讀本	GAD AAB
讀法	GAD A9P
讀者	GAD XOR
讀音	GAD H1Y
變動	AGK GAB
變化	AGK INI
變奏	AGK NZC
變幻	AGK JEI
變形	AGK JVQ
變心	AGK Q1Q
變態	AGK FTS
變換	AGK JCI
變法	AGK A9P
變異	AGK LHS
變色	AGK VWT
變賣	AGK DPC
變遷	AGK OGQ
變革	AGK DTT
讓座	CPS PLI
豁免	ICJ DGJ
豁然	ICJ CGQ
豆漿	GZC NPQ
豆瓣	GZC CEC
豆腐	GZC CKN
豆蔻	GZC IZC
豆豉	GZC ZFS
豆類	GZC IGI
豈止	EID XHR
豌豆	HCG GZC
豎琴	ZKH F1Y
豐富	BBM AYO
豐潤	BBM CVI
豐碩	BBM ZUT
豐腴	BBM LKG
豪宅	JKQ LRT
豪爽	JKQ VPR
豪邁	JKQ DRC
豬排	JJQ CQA
豬肉	JJQ CBD
負責	CYN STT
負面	CYN DGG
財力	PTQ IWT
財務	PTQ DKO
財團	PTQ GCG
財富	PTQ AYO
財帛	PTQ CRD
財政	PTQ XUS
財物	PTQ DXP
財神	PTQ BVQ
貧困	CVI EAI
貧窮	CVI FBM
貧血	CVI IFJ
貨品	ILI B1J
貨幣	ILI CNG
貨架	ILI DNS
貨機	ILI DIC
貨櫃	ILI FGQ
貨款	ILI ECH
貨源	ILI GZS
貨物	ILI DXP
貨站	ILI J6S
貨船	ILI BGG
貨色	ILI VWT
貨運	ILI KXU
販毒	AZO GCD
販運	AZO KXU
貪婪	F2Q I2Q
貪官	F2Q DCG
貯存	JJR PAG
貴族	DIU PAD
貶值	A4J LHS
買家	DPB DNQ
買賣	DPB DPC
貸款	FTS ECH
貼心	F5T Q1Q
貼現	F5T JFS
貼身	F5T AVQ
貿然	DZC CGQ
資本	NGQ AAB
資歷	NGQ IVT
資源	NGQ GZS
資訊	NGQ QVS
資金	NGQ D1Y
賒帳	AOQ JPS
賞光	APR DQG
賞析	APR QVT
賞識	APR AWT
賣力	DPC IWT
賣家	DPC DNQ
賣座	DPC PLI
賣弄	DPC IAC
賣點	DPC E5R
賤賣	PGS DPC
賦閒	AKO DEQ
賭場	ELB LPQ
賭徒	ELB GLA
賭注	ELB XKI
賴以	IOS LHR
購物	DZC DXP
購置	DZC JHS
購買	DZC DPB
賽跑	QTS BJB
賽馬	QTS DNB
贏得	LUQ EXT
赤字	YUT PHS
赤腳	YUT DPF
赤裸	YUT ILH
赤道	YUT GKR
赫然	IRT CGQ
起來	EHD ITQ
起初	EHD TJQ
起勁	EHD DUW
起因	EHD HVU
起床	EHD UPQ
起步	EHD CLC
起源	EHD GZS
起火	EHD ILH
起碼	EHD DNB
起程	EHD LUQ
起義	EHD GFA
起落	EHD IQT
起訴	EHD QLC
起身	EHD AVQ
起點	EHD E5R
超人	KIQ CVQ
超值	KIQ LHS
超前	KIQ PFQ
超支	KIQ XFQ
超時	KIQ ZHQ
超級	KIQ D1B
超額	KIQ GRT
趨勢	OKG ANS
跌宕	GFT GQS
跌落	GFT IQT
跑步	BJB CLC
跑馬	BJB DNB
跟前	DBQ PFQ
跟進	DBQ NVS
跟隨	DBQ RFG
路人	ILC CVQ
路子	ILC NHR
路徑	ILC DVS
路燈	ILC EXQ
路程	ILC LUQ
路線	ILC QGS
路軌	ILC DGP
路面	ILC DGG
跳動	GHQ GAB
跳板	GHQ ADB
跳繩	GHQ BWQ
跳舞	GHQ DKN
跳蚤	GHQ NKR
跳躍	GHQ LPT
踱步	GQT CLC
蹤影	NDA HSZ
躍升	LPT AWQ
身份	AVQ AVI
身價	AVQ DNS
身子	AVQ NHR
身孕	AVQ LWS
身形	AVQ JVQ
身影	AVQ HSZ
身心	AVQ Q1Q
身材	AVQ PTQ
身段	AVQ GCI
身軀	AVQ EKS
身邊	AVQ AFA
身體	AVQ FMR
軀幹	EKS DCS
軀體	EKS FMR
軌跡	DGP NUT
軌道	DGP GKR
軍人	DXS CVQ
軍團	DXS GCG
軍官	DXS DCG
軍民	DXS DVE
軍營	DXS LUG
軍艦	DXS J7R
軍閥	DXS CZP
軍隊	DXS GSI
軟骨	CGH DAJ
軸心	LBD Q1Q
輔佐	CKN NLS
輔助	CKN UJS
輔導	CKN GKS
輔幣	CKN CNG
輝映	IIS HSA
輝煌	IIS JQG
輪廓	IVG EQJ
輪流	IVG IYA
輪班	IVG ADA
輪胎	IVG FTQ
輪船	IVG BGG
辛勤	QVQ FYC
辛酸	QVQ QCG
辦學	CEC JED
辦法	CEC A9P
辦理	CEC IHR
辭職	RHQ XWT
辭藻	RHQ NKR
辮子	CFB NHR
辯證	CGJ XWS
辯護	CGJ JLC
辯駁	CGJ AED
農具	HCA FKU
農地	HCA GGS
農場	HCA LPQ
農曆	HCA IVT
農村	HCA OAG
農業	HCA G8F
農民	HCA DVE
農田	HCA GFQ
農莊	HCA SPQ
農藥	HCA LPT
迂腐	HKS CKN
迂迴	HKS JSG
迄今	IYF D1Y
迅速	QVS QAD
返回	AZN JSG
返潮	AZN LIQ
迥然	JVH CGQ
迫害	ARD JOS
迷亂	DMA ICI
迷人	DMA CVQ
迷信	DMA QVS
迷宮	DMA DBM
迷惘	DMA DPN
迷戀	DMA IGI
迷糊	DMA JLA
迷茫	DMA DQA
迷路	DMA ILC
迸發	ATC AZP
追尋	JGG R1Q
追憶	JGG HWF
追捕	JGG CLC
追捧	JGG BDN
追擊	JGG DVT
追求	JGG FYM
追究	JGG DYO
追蹤	JGG NDA
追逐	JGG LBD
追隨	JGG RFG
退休	FSI IYM
退化	FSI INI
退回	FSI JSG
退學	FSI JED
退席	FSI RUT
退役	FSI LUJ
退款	FSI ECH
退熱	FSI CGT
退縮	FSI VBD
退讓	FSI CPS
送別	QAC CGL
逃亡	GKQ DPM
逃命	GKQ DSK
逃犯	GKQ C9N
逃跑	GKQ BJB
逃避	GKQ CFG
逆境	GSB DSZ
逍遙	QIQ LIQ
透鏡	FZC DSA
透露	FZC ILC
逐年	LBD HFQ
逐步	LBD CLC
途人	GLA CVQ
途徑	GLA DVS
這個	XOR DLS
這裏	XOR IHR
這麼	XOR DLB
通俗	FAA RDD
通訊/通信	FAA QVS
通報	FAA AKC
通宵	FAA QIQ
通常	FAA ZPQ
通暢	FAA KPS
通曉	FAA IHR
通用	FAA LDC
通知	FAA JFQ
通紅	FAA JAA
通緝	FAA O1T
通脹	FAA JPS
通話	FAA JRI
通貨	FAA ILI
通透	FAA FZC
通道	FAA GKR
通關	FAA DDG
通電	FAA GFS
連串	IGQ DDI
連同	IGQ GAA
連夜	IGQ LOS
連帶	IGQ EOS
連忙	IGQ DQA
連接	IGQ N4T
連環	IGQ JDG
連結	IGQ DFT
連續	IGQ RDD
連袂	IGQ DNG
連襟	IGQ D1Y
連鎖	IGQ QLH
進來	NVS ITQ
進入	NVS C1T
進化	NVS INI
進口	NVS EZB
進展	NVS JGR
進步	NVS CLC
進發	NVS AZP
進程	NVS LUQ
進而	NVS CHQ
進貢	NVS DAC
進軍	NVS DXS
進駐	NVS JKI
逾期	LKG FHC
遊人	LYA CVQ
遊學	LYA JED
遊客	LYA ERT
遊歷	LYA IVT
遊玩	LYA GCI
遊艇	LYA GVR
遊記	LYA DHE
遊輪	LYA IVG
運動	KXU GAB
運河	KXU JLQ
運營	KXU LUG
運用	KXU LDC
運算	KXU QCH
運籌	KXU LYA
運送	KXU QAC
遍及	AFC F1B
遍地	AFC GGS
遏制	HCT XNS
遏抑	HCT HWB
遏止	HCT XHR
遐想	JNQ QPR
遐邇	JNQ CFR
道具	GKR FKU
道士	GKR UHR
道家	GKR DNQ
道德	GKR EXT
道理	GKR IHR
道義	GKR GFA
道袍	GKR CKA
道謝	GKR ROS
道路	GKR ILC
違例	KIS INS
違法	KIS A9P
違規	KIS DFK
遜色	QAI VWT
遨遊	GKQ LYA
遭受	NKQ ZYB
遭遇	NKQ GKU
遮掩	XOQ H4Z
遮擋	XOQ EQS
遮蔽	XOQ ANG
遲到	LGQ EKS
遲早	LGQ NKR
遲緩	LGQ JCH
遲鈍	LGQ GAI
遵循	NVG RVG
遷就	OGQ PYC
遷徙	OGQ QFR
遷移	OGQ LFQ
遼闊	IHQ ECJ
避免	CFG DGJ
避忌	CFG FHE
避暑	CFG AJR
邁進	DRC NVS
邂逅	JPS JZC
邊境	AFA DSZ
邊界	AFA DQS
邊疆	AFA DPC
邊緣	AFA LGG
邊陲	AFA ZFG
邊際	AFA NNS
邏輯	ILS P1T
郊外	DJQ GOI
郊遊	DJQ LYA
郵件	KYM FGZ
郵包	KYM AJA
郵品	KYM B1J
郵局	KYM FDP
郵政	KYM XUS
郵箱	KYM QPQ
郵輪	KYM IVG
都市	ELA ZHR
鄉村	IPC OAG
鄉音	IPC H1Y
鄰舍	IVQ AOR
酌情	XPT PUQ
配件	BSC FGZ
配備	BSC CGK
配售	BSC ZYC
配對	BSC ESI
配給	BSC D1B
配置	BSC JHS
配藥	BSC LPT
配製	BSC XNS
配角	BSC DED
配音	BSC H1Y
配額	BSC GRT
配飾	BSC AWT
酒家	NYB DNQ
酒店	NYB E5S
酒杯	NYB ASA
酒樓	NYB IZA
酒精	NYB NUQ
酒館	NYB DCI
酥脆	QLA ONI
酬金	ZYA D1Y
酷刑	ECD JVQ
酷愛	ECD HTS
酷暑	ECD AJR
酷熱	ECD CGT
酸性	QCG QUS
酸痛	QCG FAC
醉人	NGI CVQ
醉心	NGI Q1Q
醜陋	YYB IZC
醫學	HHC JED
醫師	HHC VGQ
醫療	HHC IIS
醫藥	HHC LPT
醫護	HHC JLC
釀酒	MPS NYB
釋然	AUT CGQ
里程	IHR LUQ
金剛	D1Y DQQ
金子	D1Y NHR
金礦	D1Y DRH
金箔	D1Y CQD
金色	D1Y VWT
金融	D1Y LBA
金額	D1Y GRT
金飾	D1Y AWT
金黃	D1Y JQG
釣魚	EHS GJC
鈴聲	IVQ AUQ
鉛筆	LGG AVL
銀元	GVY GZS
銀幕	GVY DQD
銀杏	GVY JRR
銀河	GVY JLQ
銀色	GVY VWT
銅像	GAA RPR
銅器	GAA EGA
銘文	DVA DXM
銷售	QIQ ZYC
鋸齒	DJE YHR
鋼琴	DQQ F1Y
鋼筋	DQQ DYC
鋼鐵	DQQ FFT
錦囊	D1Z HQQ
錦鯉	D1Z IHR
鍋巴	DLG ANA
鍛鍊	ECI IFS
鍾情	XDA PUQ
鍾愛	XDA HTS
鏗鏘	ETQ OPQ
鏡子	DSA NHR
鏡片	DSA BFC
鏡頭	DSA GZA
鐘樓	XDA IZA
鐘頭	XDA GZA
鐵板	FFT ADB
鐵欄	FFT ICQ
鐵路	FFT ILC
鑰匙	LPT ZFQ
門口	DAA EZB
門市	DAA ZHR
門徒	DAA GLA
門框	DAA EPS
門楣	DAA DGI
門檻	DAA J7R
門第	DAA GMS
門路	DAA ILC
門鈴	DAA IVQ
開口	ETQ EZB
開場	ETQ LPQ
開墾	ETQ EBR
開始	ETQ AHR
開展	ETQ JGR
開幕	ETQ DQD
開庭	ETQ GVQ
開心	ETQ Q1Q
開懷	ETQ JQG
開採	ETQ OTR
開支	ETQ XFQ
開朗	ETQ IQR
開業	ETQ G8F
開水	ETQ AGH
開演	ETQ LGR
開發	ETQ AZP
開盤	ETQ CCA
開竅	ETQ EHS
開端	ETQ ECG
開腔	ETQ EEA
開花	ETQ ING
開設	ETQ AGT
開賽	ETQ QTS
開辦	ETQ CEC
開通	ETQ FAA
開銷	ETQ QIQ
開鑼	ETQ ILQ
開門	ETQ DAA
開闊	ETQ ECJ
開關	ETQ DDG
開闢	ETQ CUH
開頭	ETQ GZA
閒暇	DEQ JNS
閒談	DEQ G3Q
間或	DES JXJ
間接	DES N4T
間歇	DES IZF
間諜	DES G5T
間隔	DES DTT
閣樓	DQT IZA
閱歷	LGJ IVT
閱覽	LGJ I3R
閱讀	LGJ GAD
闊別	ECJ CGL
闊綽	ECJ YPT
關乎	DDG JLA
關係	DDG DMS
關子	DDG NHR
關心	DDG Q1Q
關愛	DDG HTS
關懷	DDG JQG
關注	DDG XKI
關稅	DDG ANI
關節	DDG NFT
關連	DDG IGQ
關門	DDG DAA
闡明	YGR DSI
闡述	YGR BVJ
闡釋	YGR AUT
阻力	SJR IWT
阻礙	SJR GTS
阻隔	SJR DTT
阿姨	HLQ LGQ
附件	CKO FGZ
附加	CKO DNQ
附設	CKO AGT
陋習	IZC R1T
陌生	DRD VSQ
陌路	DRD ILC
限價	JER DNS
限制	JER XNS
限期	JER FHC
陡峭	EZB OIS
陣地	LVS GGS
陣容	LVS LDA
陪同	CSA GAA
陪葬	CSA NQS
陪襯	CSA TWS
陰影	H1Y HSZ
陰性	H1Y QUS
陰曆	H1Y IVT
陰沉	H1Y L1Q
陰謀	H1Y DYM
陰陽	H1Y LPQ
陰險	H1Y I4Z
陵園	IWQ KZS
陵墓	IWQ DLC
陷入	J6S C1T
陷阱	J6S PUR
陸地	IBD GGS
陸續	IBD RDD
陸路	IBD ILC
陸軍	IBD DXS
陽傘	LPQ QCR
陽光	LPQ DQG
陽剛	LPQ DQQ
陽性	LPQ QUS
陽曆	LPQ IVT
陽臺	LPQ GTQ
隊伍	GSI GLB
隊友	GSI KYN
階層	DQQ PXQ
階梯	DQQ FMQ
階段	DQQ GCI
階級	DQQ D1B
隔壁	DTT AVD
隔夜	DTT LOS
隔音	DTT H1Y
隧道	RGI GKR
隨即	RFG NWT
隨意	RFG HHE
隨時	RFG ZHQ
隨身	RFG AVQ
險峻	I4Z QVI
隸書	IMS AJQ
雀斑	NPT ADA
雀躍	NPT LPT
雄偉	KBM KIT
雄健	KBM FZE
雄心	KBM Q1Q
雄性	KBM QUS
雄踞	KBM DJE
雅致	GNR JGS
集中	P1T JBA
集團	P1T GCG
集市	P1T ZHR
集結	P1T DFT
集訓	P1T IXU
集資	P1T NGQ
集體	P1T FMR
雋永	PGH KSP
雌性	OFQ QUS
雕像	EHQ RPR
雕刻	EHQ EXT
雕塑	EHQ QLC
雕琢	EHQ JED
雕飾	EHQ AWT
雖然	QGG CGQ
雙向	VEA IPE
雙贏	VEA LUQ
雙邊	VEA AFA
雛形	UKG JVQ
雜亂	P2T ICI
雜務	P2T DKO
雜技	P2T FFZ
雜物	P2T DXP
雜誌	P2T XHS
雜貨	P2T ILI
雞肉	DMQ CBD
雞肋	DMQ IXT
雪梨	QGJ IGQ
雪白	QGJ CRD
雪花	QGJ ING
雲層	KXS PXQ
雲梯	KXS FMQ
雲集	KXS P1T
雷同	ISG GAA
電訊/電信	GFS QVS
電力	GFS IWT
電動	GFS GAB
電器	GFS EGA
電報	GFS AKC
電壓	GFS H7T
電子	GFS NHR
電影	GFS HSZ
電梯	GFS FMQ
電池	GFS LFQ
電波	GFS ALA
電流	GFS IYA
電源	GFS GZS
電燈	GFS EXQ
電網	GFS DPN
電線	GFS QGS
電纜	GFS I3S
電臺	GFS GTQ
電話	GFS JRI
電路	GFS ILC
電鈴	GFS IVQ
電阻	GFS SJR
需求	QKG FYM
震動	XVS GAB
震懾	XVS X4T
震撼	XVS J2R
震驚	XVS DSY
霍亂	IQJ ICI
霍然	IQJ CGQ
霜花	VPQ ING
露天	ILC FFQ
露水	ILC AGH
露營	ILC LUG
露臺	ILC GTQ
露骨	ILC DAJ
霸主	ANC XKH
靈位	IVQ KGQ
靈光	IVQ DQG
靈性	IVQ QUS
靈感	IVQ D2R
靈敏	IVQ DVJ
靈機	IVQ DIC
靈芝	IVQ XHQ
靈驗	IVQ G4A
靜態	PUR FTS
靜止	PUR XHR
靜電	PUR GFS
非凡	AIM C9M
非常	AIM ZPQ
非法	AIM A9P
面值	DGG LHS
面具	DGG FKU
面前	DGG PFQ
面孔	DGG EAB
面目	DGG DBP
面紗	DGG VNQ
面罩	DGG JJS
面色	DGG VWT
面試	DGG AHS
面談	DGG G3Q
面貌	DGG DJC
面頰	DGG D5T
面額	DGG GRT
靦腆	FFR FFR
革命	DTT DSK
革新	DTT QVQ
革職	DTT XWT
鞏固	DDN DLC
鞭子	AGE NHR
鞭炮	AGE BJC
韌帶	CVS EOS
韭菜	DYN OTS
音符	H1Y CKM
音節	H1Y NFT
音色	H1Y VWT
音階	H1Y DQQ
音韻	H1Y KXU
音響	H1Y IPD
韻味	KXU DIO
韻律	KXU IVJ
響應	IPD HWE
響聲	IPD AUQ
頂樓	EVR IZA
頂端	EVR ECG
頂級	EVR D1B
頂點	EVR E5R
項目	JEB DBP
順利	BVI IGS
順勢	BVI ANS
順境	BVI DSZ
順序	BVI RJR
順應	BVI HWE
順手	BVI AYB
順暢	BVI KPS
順道	BVI GKR
預備	LJS CGK
預報	LJS AKC
預定	LJS GVS
預感	LJS D2R
預期	LJS FHC
預測	LJS TWT
預科	LJS ELG
預算	LJS QCH
預習	LJS R1T
預言	LJS GZC
預計	LJS DMS
預謀	LJS DYM
預警	LJS DSZ
頑劣	GDG IGJ
頑強	GDG FPC
頑疾	GDG PVT
頓時	EAI ZHQ
領域	IUR KWR
領導	IUR GKS
領帶	IUR EOS
領悟	IUR GLC
領略	IUR IPT
領航	IUR JQQ
領袖	IUR RYC
領軍	IUR DXS
領隊	IUR GSI
頭暈	GZA KXU
頭條	GZA GHQ
頭疼	GZA GCA
頭痛	GZA FAC
頭皮	GZA CFI
頭等	GZA EXR
頭緒	GZA RJR
頭腦	GZA HKR
頭銜	GZA J7Q
頭頂	GZA EVR
頭髮	GZA AZP
頻道	CVE GKR
顆粒	ELH I1T
額外	GRT GOI
額頭	GRT GZA
顏色	GDQ VWT
願意	GZU HHE
類似	IGI RHR
類別	IGI CGL
類型	IGI JVQ
顧及	DLC F1B
顧問	DLC DXO
顧客	DLC ERT
顧忌	DLC FHE
顧慮	DLC IJS
顫動	XGS GAB
顫抖	XGS EZB
顯得	IFR EXT
顯然	IFR CGQ
顯現	IFR JFS
顯眼	IFR GER
顯赫	IFR IRT
顯露	IFR ILC
飛天	AIM FFQ
飛快	AIM ERI
飛揚	AIM LPQ
飛機	AIM DIC
飛翔	AIM RPQ
飛舞	AIM DKN
飛船	AIM BGG
飛躍	AIM LPT
飛鳥	AIM EHR
飢餓	DGY GLS
飽受	AJB ZYB
飽學	AJB JED
飽滿	AJB DCB
飽覽	AJB I3R
飾品	AWT B1J
飾演	AWT LGR
飾物	AWT DXP
餐具	OCQ FKU
餐巾	OCQ DVY
餐廳	OCQ FVQ
餐桌	OCQ JED
餐館	OCQ DCI
餐點	OCQ E5R
餘光	LJQ DQG
餘地	LJQ GGS
餘韻	LJQ KXU
餘額	LJQ GRT
餛飩	JAG GAG
饅頭	DCA GZA
饋贈	FGQ PXS
香味	IPC DIO
香檳	IPC AVE
香水	IPC AGH
香火	IPC ILH
香爐	IPC ILA
香片	IPC BFC
香甜	IPC G5Q
香草	IPC OKR
香蕉	IPC NIQ
香醇	IPC ZVG
馬匹	DNB BVH
馬術	DNB BVJ
馬路	DNB ILC
馳名	LFQ DUE
馳騁	LFQ KUR
馴服	RVG CBP
駁回	AED JSG
駁斥	AED YUT
駐軍	JKI DXS
駕馭	DNS GJE
駕駛	DNS VHR
駭客	JQR ERT
駱駝	IQT GLQ
駿馬	NVI DNB
騰飛	GXQ AIM
騷亂	QKQ ICI
騷動	QKQ GAB
騷擾	QKQ CIR
驀地	DRD GGS
驀然	DRD CGQ
驕人	DIY CVQ
驕傲	DIY GKS
驗證	G4A XWS
驚人	DSY CVQ
驚呼	DSY ILA
驚喜	DSY IHD
驚惶	DSY JQG
驚愕	DSY GQT
驚異	DSY LHS
驚訝	DSY GNS
驚險	DSY I4Z
驟然	UYC CGQ
骨幹	DAJ DCS
骨架	DAJ DNS
骨灰	DAJ ISG
骨碌	DAJ IAD
骨科	DAJ ELG
骨頭	DAJ GZA
骨骼	DAJ DRT
骨髓	DAJ QFH
骸骨	JQQ DAJ
體制	FMR XNS
體力	FMR IWT
體味	FMR DIO
體型/體形	FMR JVQ
體察	FMR TET
體弱	FMR CPT
體恤	FMR QVJ
體態	FMR FTS
體液	FMR LUT
體溫	FMR HAG
體現	FMR JFS
體系	FMR JMS
體育	FMR LBD
體驗	FMR G4A
髮型	AZP JVQ
髮式	AZP AWT
鬥爭	EZC STQ
鬥牛	EZC GYM
鬱結	HXV DFT
鬼子	DIT NHR
鬼怪	DIT DQI
鬼魅	DIT DGK
魅力	DGK IWT
魅惑	DGK JXJ
魔力	DLA IWT
魔幻	DLA JEI
魔法	DLA A9P
魔術	DLA BVJ
魚缸	GJC JEA
魚翅	GJC AFS
魚餌	GJC CHS
魚鱗	GJC IVQ
鮑魚	CJB GJC
鯉魚	IHR GJC
鯊魚	VNQ GJC
鳥瞰	EHR E3S
鳳梨	CBO IGQ
鴉片	HNQ BFC
鴛鴦	HZS HPC
鴿子	D2T NHR
鵝肝	GLQ DCQ
鸚鵡	HTQ DKN
鹹魚	J6Q GJC
鹿茸	IAD CDA
麒麟	FHC IVQ
麵包	DFC AJA
麵粉	DFC AXN
麻煩	DNA CZM
麻疹	DNA XVR
麻醉	DNA NGI
黃昏	JQG IAG
黃色	JQG VWT
黃豆	JQG GZC
黃金	JQG D1Y
黎明	IMQ DSI
黎民	IMQ DVE
黏液	M4Q LUT
黑人	IXT CVQ
黑夜	IXT LOS
黑暗	IXT H2S
黑板	IXT ADB
黑白	IXT CRD
黑馬	IXT DNB
默哀	DXD HTQ
默寫	DXD QOR
默書	DXD AJQ
默然	DXD CGQ
默許	DXD IJD
默默	DXD DXD
黝黑	H0V IXT
點心	E5R Q1Q
點擊	E5R DVT
點滴	E5R EVT
點燃	E5R CGQ
點球	E5R FYM
點頭	E5R GZA
黨員	EQR KXS
黨魁	EQR ESG
黯然	H6R CGQ
鼎力	EVR IWT
鼻子	CGG NHR
鼻孔	CGG EAB
龍井	IDA NUR
龍舟	IDA XYA
龍蝦	IDA JNQ
龍門	IDA DAA
龍頭	IDA GZA
龍鳳	IDA CBO
一下子	HVX JNR NHR
一口氣	HVX EZB EIE
一塊兒	HVX ESI CFQ
一會兒	HVX JOI CFQ
一條龍	HVX GHQ IDA
一輩子	HVX ASC NHR
一點兒	HVX E5R CFQ
三角形	Q3Q DED JVQ
中學生	JBA JED VSQ
主人公	XKH CVQ DAA
主持人	XKH LHQ CVQ
二流子	CGS IYA NHR
亞熱帶	HNS CGT EOS
交易所	DJQ LUT VJR
交易額	DJQ LUT GRT
人情味	CVQ PUQ DIO
人民幣	CVQ DVE CNG
代理人	GTS IHR CVQ
代言人	GTS GZC CVQ
佼佼者	DJR DJR XOR
保證金	AKB XWS D1Y
保齡球	AKB IVQ FYM
信用證	QVS LDC XWS
停機坪	GVQ DIC CSI
傳教士	LGG DJS UHR
元宵節	GZS QIQ NFT
免疫力	DGJ LUJ IWT
全方位	PGG APM KGQ
全日制	PGG CVT XNS
全球化	PGG FYM INI
八哥兒	AED DLQ CFQ
公務員	DAA DKO KXS
公式化	DAA AWT INI
公有制	DAA KYN XNS
公益金	DAA HUX D1Y
公證人	DAA XWS CVQ
公開信	DAA ETQ QVS
公開賽	DAA ETQ QTS
北極熊	AXD FWF KBM
十字架	Z1T PHS DNS
半導體	ACC GKS FMR
協奏曲	J5T NZC EDP
博物館	AQD DXP DCI
印表機	HVW AIJ DIC
口風琴	EZB ABM F1Y
口香糖	EZB IPC GQQ
叫化子	DHS INI NHR
吉祥物	DVX RPQ DXP
同性戀	GAA QUS IGI
呼吸道	ILA I1B GKR
哲學家	JGT JED DNQ
售貨員	ZYC ILI KXS
國務卿	DXJ DKO ESY
國際化	DXJ NNS INI
圓舞曲	KGO DKN EDP
圖書館	GLA AJQ DCI
地鐵站	GGS FFT J6S
基本功	DHC AAB DAA
基本法	DHC AAB A9P
基督教	DHC ECD DJS
壓歲錢	H7T QNI PGQ
外國人	GOI DXJ CVQ
外星人	GOI QVQ CVQ
外祖母	GOI NLB DZB
多元化	ELQ GZS INI
多媒體	ELQ DSA FMR
天主教	FFQ XKH DJS
天花板	FFQ ING ADB
太極拳	FOS FWF FGO
太空人	FOS EAA CVQ
太陽系	FOS LPQ JMS
奏鳴曲	NZC DSI EDP
字帖兒	PHS F5T CFQ
宇航員	KKT JQQ KXS
安全帶	HCQ PGG EOS
安全感	HCQ PGG D2R
安息日	HCQ QWT CVT
安眠藥	HCQ DFA LPT
家常菜	DNQ ZPQ OTS
寫字樓	QOR PHS IZA
專利權	XGG IGS FGO
對講機	ESI DEB DIC
小孩兒	QIR JTQ CFQ
小學生	QIR JED VSQ
小朋友	QIR CXA KYN
展覽館	JGR I3R DCI
工商業	DAA APQ G8F
工業化	DAA G8F INI
工程師	DAA LUQ VGQ
年頭兒	HFQ GZA CFQ
幻燈片	JEI EXQ BFC
幼稚園	H0W LGS KZS
建築師	DZE JBD VGQ
建築物	DZE JBD DXP
影印機	HSZ HVW DIC
律政司	IVJ XUS QHQ
微生物	DIM VSQ DXP
心理學	Q1Q IHR JED
必需品	AVH QKG B1J
悄悄話	OIR OIR JRI
情人節	PUQ CVQ NFT
想像力	QPR RPR IWT
慢悠悠	DDC LYA LYA
懶洋洋	ICR LPQ LPQ
成員國	ZUQ KXS DXJ
成年人	ZUQ HFQ CVQ
戒毒所	DQS GCD VJR
所有制	VJR KYN XNS
手工藝	AYB DAA GNW
批發價	BMA AZP DNS
技術員	FFZ BVJ KXS
抗藥性	EQS LPT QUS
拖拉機	FLS I2T DIC
指揮家	XGR IIS DNQ
揚聲器	LPQ AUQ EGA
擴音器	JQI H1Y EGA
擺架子	APB DNS NHR
文縐縐	DXM SYC SYC
斑馬線	ADA DNB QGS
日光浴	CVT DQG LDD
日光燈	CVT DQG EXQ
普通法	BLB FAA A9P
普通話	BLB FAA JRI
服務員	CBP DKO KXS
根據地	DBQ DJE GGS
機器人	DIC EGA CVQ
機械化	DIC JQS INI
檢察官	D4Z TET DCG
檸檬茶	MRR DAA LNQ
櫃員機	FGQ KXS DIC
歌唱家	DLQ YPS DNQ
止痛藥	XHR FAC LPT
歷史性	IVT VHR QUS
殖民地	ZWT DVE GGS
殯儀館	AVG GFY DCI
水龍頭	AGH IDA GZA
海岸線	ITR GCS QGS
混日子	JAH CVT NHR
清明節	OUQ DSI NFT
灰蒙蒙	ISG DAA DAA
烏龍茶	HLA IDA LNQ
無名指	DKM DUE XGR
無所謂	DKM VJR KIU
無線電	DKM QGS GFS
無花果	DKM ING DLH
牙周病	GNQ XYA CSK
獨木舟	GAD DAD XYA
獨角獸	GAD DED AYC
現代化	JFS GTS INI
甲骨文	D7T DAJ DXM
男子漢	H2Q NHR ICS
男孩兒	H2Q JTQ CFQ
病原體	CSK GZS FMR
發動機	AZP GAB DIC
發展商	AZP JGR APQ
發源地	AZP GZS GGS
發牢騷	AZP IKQ QKQ
發祥地	AZP RPQ GGS
發言人	AZP GZC CVQ
發言權	AZP GZC FGO
發電機	AZP GFS DIC
白木耳	CRD DAD CHR
白熱化	CRD CGT INI
白皮書	CRD CFI AJQ
白茫茫	CRD DQA DQA
白蘭地	CRD ICQ GGS
白血球	CRD IFJ FYM
白血病	CRD IFJ CSK
白話文	CRD JRI DXM
目的地	DBP EVT GGS
直升機	LWT AWQ DIC
直溜溜	LWT IYC IYC
眼珠子	GER XKG NHR
研究員	GFS DYO KXS
破天荒	BLC FFQ IQG
礦泉水	DRH PGG AGH
私有化	QGQ KYN INI
科學家	ELG JED DNQ
端午節	ECG GLB NFT
競爭力	FSA STQ IWT
筆記本	AVL DHE AAB
精神病	NUQ BVQ CSK
糖尿病	GQQ HHS CSK
紀念品	DHD H5S B1J
紀念日	DHD H5S CVT
紀念碑	DHD H5S AFI
紀念館	DHD H5S DCI
紅血球	JAA IFJ FYM
納悶兒	H2T DAC CFQ
紫外線	NFR GOI QGS
終端機	XBA ECG DIC
維他命	LGG FLQ DSK
繼承人	DMS ZWQ CVQ
繼承權	DMS ZWQ FGO
纖維素	Q4Q LGG QLC
老人家	IKR CVQ DNQ
老太太	IKR FOS FOS
老年人	IKR HFQ CVQ
老百姓	IKR ARD QUS
老頭兒	IKR GZA CFQ
老頭子	IKR GZA NHR
考古學	EKR DLB JED
聊天兒	IHQ FFQ CFQ
職業病	XWT G8F CSK
胡椒粉	JLA NIQ AXN
胡蘿蔔	JLA ILQ CXD
膽固醇	E3R DLC ZVG
自信心	PGS QVS Q1Q
自助餐	PGS UJS OCQ
自動化	PGS GAB INI
自然界	PGS CGQ DQS
航海家	JQQ ITR DNQ
芝麻醬	XHQ DNA NPS
芭蕾舞	ANA ISH DKN
藍籌股	I3Q LYA DLB
藝術品	GNW BVJ B1J
藝術家	GNW BVJ DNQ
血友病	IFJ KYN CSK
血小板	IFJ QIR ADB
血淋淋	IFJ I1Q I1Q
規範化	DFK C9N INI
設計師	AGT DMS VGQ
許可證	IJD ELR XWS
試用期	AHS LDC FHC
試金石	AHS D1Y ZUT
讀書人	GAD AJQ CVQ
變電站	AGK GFS J6S
豆腐乳	GZC CKN CKH
負責人	CYN STT CVQ
賣關子	DPC DDG NHR
起訴書	EHD QLC AJQ
輔導員	CKN GKS KXS
辦公室	CEC DAA AVT
辯護人	CGJ JLC CVQ
迪士尼	GVT UHR MGQ
退休金	FSI IYM D1Y
通心粉	FAA Q1Q AXN
進口商	NVS EZB APQ
運動員	KXU GAB KXS
運動場	KXU GAB LPQ
運動服	KXU GAB CBP
酸溜溜	QCG IYC IYC
醜八怪	YYB AED DQI
里程碑	IHR LUQ AFI
金字塔	D1Y PHS F3T
鋼琴家	DQQ F1Y DNQ
開場白	ETQ LPQ CRD
開心果	ETQ Q1Q DLH
開發商	ETQ AZP APQ
附加值	CKO DNQ LHS
陪審員	CSA A1R KXS
陪審團	CSA A1R GCG
集裝箱	P1T SPQ QPQ
雞尾酒	DMQ DIN NYB
電子琴	GFS NHR F1Y
電影節	GFS HSZ NFT
電氣化	GFS EIE INI
電話線	GFS JRI QGS
靜悄悄	PUR OIR OIR
頂呱呱	EVR DLA DLA
顯微鏡	IFR DIM DSA
馬拉松	DNB I2T RDA
體溫計	FMR HAG DMS
髮型師	AZP JVQ VGQ
鬼門關	DIT DAA DDG
魔術師	DLA BVJ VGQ
魚子醬	GJC NHR NPS
麥芽糖	DTD GNQ GQQ
麻醉藥	DNA NGI LPT
一勞永逸	HVX IKQ KSP LVT
一呼百應	HVX ILA ARD HWE
一帆風順	HVX C9M ABM BVI
一廂情願	HVX QPQ PUQ GZU
一掃而空	HVX QKR CHQ EAA
一日千里	HVX CVT OFQ IHR
一朝一夕	HVX JIQ HVX RUT
一枝獨秀	HVX XFQ GAD QYC
一清二楚	HVX OUQ CGS TJS
一無所有	HVX DKM VJR KYN
一目了然	HVX DBP IHR CGQ
一舉兩得	HVX DJD IPR EXT
一見如故	HVX DFS CJQ DLC
一觸即發	HVX YDD NWT AZP
一頭霧水	HVX GZA DKO AGH
亂七八糟	ICI OVT AED NKQ
五花八門	GLB ING AED DAA
井井有條	NUR NUR KYN GHQ
亦步亦趨	LUT CLC LUT OKG
人傑地靈	CVQ FGB GGS IVQ
人山人海	CVQ VEQ CVQ ITR
似是而非	RHR ZFR CHQ AIM
俯拾皆是	AKN Z1T DQQ ZFR
價廉物美	DNS I4Q DXP DGJ
入鄉隨俗	C1T IPC RFG RDD
全力以赴	PGG IWT LHR BKO
全心全意	PGG Q1Q PGG HHE
再接再厲	NTS N4T NTS INS
凡夫俗子	C9M AKM RDD NHR
別有用心	CGL KYN LDC Q1Q
刻骨銘心	EXT DAJ DVA Q1Q
前所未有	PFQ VJR DIO KYN
勇往直前	LDB KPT LWT PFQ
十全十美	Z1T PGG Z1T DGJ
千瘡百孔	OFQ TPQ ARD EAB
千篇一律	OFQ BGE HVX IVJ
千絲萬縷	OFQ QHQ DZO IKH
半信半疑	ACC QVS ACC GHC
卓有成效	JED KYN ZUQ JJS
南轅北轍	H2Q KZS AXD LGT
口誅筆伐	EZB JKG AVL CZP
古色古香	DLB VWT DLB IPC
史無前例	VHR DKM PFQ INS
各就各位	DQT PYC DQT KGQ
同心協力	GAA Q1Q J5T IWT
名存實亡	DUE PAG BVT DPM
唾手可得	FLI AYB ELR EXT
問心無愧	DXO Q1Q DKM DGQ
喜氣洋洋	IHD EIE LPQ LPQ
因地制宜	HVU GGS XNS GFY
地動山搖	GGS GAB VEQ LIQ
多愁善感	ELQ UYA ZGR D2R
多才多藝	ELQ PTQ ELQ GNW
多此一舉	ELQ OFR HVX DJD
天南地北	FFQ H2Q GGS AXD
天荒地老	FFQ IQG GGS IKR
奄奄一息	H4Z H4Z HVX QWT
字正腔圓	PHS XUS EEA KGO
學以致用	JED LHR JGS LDC
實至名歸	BVT XGS DUE DIS
山清水秀	VEQ OUQ AGH QYC
形形色色	JVQ JVQ VWT VWT
彬彬有禮	AVI AVI KYN IMR
徒勞無功	GLA IKQ DKM DAA
得心應手	EXT Q1Q HWE AYB
得意忘形	EXT HHE DPO JVQ
循循善誘	RVG RVG ZGR LYB
循規蹈矩	RVG DFK GKS DKT
心曠神怡	Q1Q EQI BVQ LHQ
心有餘悸	Q1Q KYN LJQ FGM
忍無可忍	CVR DKM ELR CVR
怦然心動	BTA CGQ Q1Q GAB
悲天憫人	AGI FFQ DVJ CVQ
應運而生	HWE KXU CHQ VSQ
手舞足蹈	AYB DKN NDD GKS
手足無措	AYB NDD DKM OLC
抑揚頓挫	HWB LPQ EAI NLI
拍案叫絕	BRD HCS DHS PGJ
拭目以待	AWT DBP LHR GTR
指日可待	XGR CVT ELR GTR
按部就班	HCS CLB PYC ADA
據理力爭	DJE IHR IWT STQ
擲地有聲	LUT GGS KYN AUQ
日新月異	CVT QVQ GZV LHS
明知故犯	DSI JFQ DLC C9N
暢所欲言	KPS VJR LDD GZC
曇花一現	G2Q ING HVX JFS
有板有眼	KYN ADB KYN GER
有聲有色	KYN AUQ KYN VWT
杳無人煙	HHR DKM CVQ HFQ
栩栩如生	IKT IKT CJQ VSQ
欣欣向榮	IYC IYC IPE KSO
歇斯底里	IZF QFQ EMR IHR
水到渠成	AGH EKS FJC ZUQ
沁人心脾	O1S CVQ Q1Q CFE
沉默寡言	L1Q DXD DNH GZC
津津有味	NVQ NVQ KYN DIO
海闊天空	ITR ECJ FFQ EAA
溫文爾雅	HAG DXM CFR GNR
灰飛煙滅	ISG AIM HFQ DGH
無懈可擊	DKM DPS ELR DVT
無拘無束	DKM DKS DKM ADD
無時無刻	DKM ZHQ DKM EXT
無關痛癢	DKM DDG FAC LPR
煥然一新	ICI CGQ HVX QVQ
燃眉之急	CGQ DGI XHQ D1B
獨一無二	GAD HVX DKM CGS
琳瑯滿目	I1Q IQQ DCB DBP
異口同聲	LHS EZB GAA AUQ
異軍突起	LHS DXS GAJ EHD
發憤圖強	AZP CXN GLA FPC
百無聊賴	ARD DKM IHQ IOS
瞬息萬變	AVI QWT DZO AGK
知己知彼	JFQ DHD JFQ AFJ
突飛猛進	GAJ AIM DRB NVS
精益求精	NUQ HUX FYM NUQ
紙醉金迷	XFR NGI D1Y DMA
紛至沓來	BXM XGS G2T ITQ
絕無僅有	PGJ DKM FVA KYN
綽綽有餘	YPT YPT KYN LJQ
繼往開來	DMS KPT ETQ ITQ
翩翩起舞	BGE BGE EHD DKN
耳目一新	CHR DBP HVX QVQ
聖誕老人	AUS GCR IKR CVQ
肅然起敬	QBD CGQ EHD DSA
肆無忌憚	QGS DKM FHE GCS
胡蘿蔔素	JLA ILQ CXD QLC
腳踏實地	DPF F2T BVT GGS
自慚形穢	PGS P3Q JVQ HUU
自欺欺人	PGS EHC EHC CVQ
萬無一失	DZO DKM HVX AVT
萬紫千紅	DZO NFR OFQ JAA
蠢蠢欲動	YVH YVH LDD GAB
觸目驚心	YDD DBP DSY Q1Q
諾貝爾獎	HQT AOC CFR NPR
變本加厲	AGK AAB DNQ INS
賞心悅目	APR Q1Q LGJ DBP
躍躍欲試	LPT LPT LDD AHS
運籌帷幄	KXU LYA KGO HED
遙遙無期	LIQ LIQ DKM FHC
金碧輝煌	D1Y ASL IIS JQG
開宗明義	ETQ NCA DSI GFA
隔靴搔癢	DTT IMS QKQ LPR
隨心所欲	RFG Q1Q VJR LDD
隨時隨地	RFG ZHQ RFG GGS
隨波逐流	RFG ALA LBD IYA
震耳欲聾	XVS CHR LDD IAA
順理成章	BVI IHR ZUQ XPQ
頭昏腦脹	GZA IAG HKR JPS
頭破血流	GZA BLC IFJ IYA
頭頭是道	GZA GZA ZFR GKR
飛禽走獸	AIM F1Y NZB AYC
鬼斧神工	DIT AKN BVQ DAA
黯然失色	H6R CGQ AVT VWT
